DataHeist_AccessCard,P	アクセスカード	Luke
DataHeist_ECT_Access,P	ユーザー: ロック中 (アクセスカードを挿入してください)	Luke
DataHeist_ECT_AccessCardInvalid,P	アクセスカードの認証情報が無効です。 セキュリティに通知されました。	Luke
DataHeist_ECT_Access_AccessCardInvalid,P	アクセスカード無効	Luke
DataHeist_ECT_Access_CardConfiscated,P	! カード没収 !	Luke
DataHeist_ECT_Access_Denied,P	アクセス拒否	Luke
DataHeist_ECT_Access_Granted,P	アクセス許可	Luke
DataHeist_ECT_Access_InsertAccessCard,P	アクセスカードを挿入	Luke
DataHeist_ECT_Access_ReadingCard,P	アクセスカード読み取り中	Luke
DataHeist_ECT_Access_SecurityBreach,P	! セキュリティ侵害を検出 - 端末がロックされました !	Luke
DataHeist_ECT_Access_SystemLockdown,P	システムロックダウン	Luke
DataHeist_ECT_Access_TerminalLocked,P	端末ロック中	Luke
DataHeist_ECT_Access_Welcome,P	ようこそ	Luke
DataHeist_ECT_AttentionRequired_TopBarInfo,P	注意事項	Luke
DataHeist_ECT_Connection_Allow,P	許可	Luke
DataHeist_ECT_Connection_Info,P	からの接続	Luke
DataHeist_ECT_Connection_Info_IP,P	~mission(IPAddress)	Luke
DataHeist_ECT_Connection_Lost,P	接続ロスト	Luke
DataHeist_ECT_Connection_Reject,P	拒否	Luke
DataHeist_ECT_Locked,P	端末がロックされています。 ITサービスにお問い合わせください。	Luke
DataHeist_ECT_LoginDetail,P	ユーザー: 管理者アクセス許可	Luke
DataHeist_ECT_Notification_ExternalRequest,P	! 外部からのアクセス要求 !	Luke
DataHeist_ECT_Notification_RemoteConnectionCancelled,P	! リモート接続キャンセル !	Luke
DataHeist_ECT_Notification_SecurityBreach,P	! セキュリティ侵害を検出 - ローカル端末をチェックしてください !	Luke
DataHeist_ECT_Notification_ServerDisconnected,P	! サーバー切断 !	Luke
DataHeist_ECT_Notification_ServerNotResponding,P	! サーバー応答なし !	Luke
DataHeist_ECT_TerminalInfo,P	外部通信	Luke
DataHeist_ECT_TopOfScreenInfo_IntrusionDetected,P	侵入を検知	Luke
DataHeist_ECT_UploadCancelled,P	アップロード中止	Luke
DataHeist_ECT_UploadComplete,P	アップロード完了	Luke
DataHeist_ECT_UploadFailed_TopBarInfo,P	アップロード失敗	Luke
DataHeist_ECT_UploadHalted_IntrusionNotify,P	ローカルコンピューターでバックドアアクセスを検出。 詳細は端末を確認してください。	Luke
DataHeist_ECT_UploadHalted_MiddleInfo,P	アップロードを続行するには、サーバーが冷えている必要があります。	Luke
DataHeist_ECT_UploadHalted_TopBarInfo,P	アップロード停止	Luke
DataHeist_ECT_Uploading_MiddleInfo_End,P	ダンプ進行中	Luke
DataHeist_ECT_Uploading_MiddleInfo_Start,P	サーバー	Luke
DataHeist_ECT_Uploading_MiddleInfo_Total,P	アップロードの進捗状況	Luke
DataHeist_ECT_Uploading_TopBarInfo,P	アップロード中...	Luke
DataHeist_IP_Generic,P	??.???.??.???	Luke
DataHeist_IntT_AdminLine,P	リセットコードは	Luke
DataHeist_IntT_DataHeist_IntT_ClimateControlDisabled,P	サーバーの空調制御は無効化されています:	Luke
DataHeist_IntT_GarbageLine,P	接続終了 - ファイアウォール有効	Luke
DataHeist_IntT_GarbageLine_01,P	アクティブなアップロードを照会 - サーバークラスタからのアクティブなアップロード	Luke
DataHeist_IntT_GarbageLine_02,P	サーバークラスタの空調制御を解除	Luke
DataHeist_IntT_GarbageLine_03,P	アップロード中止 - エラー 管理者権限が必要です	Luke
DataHeist_IntT_GarbageLine_04,P	外部からの接続	Luke
DataHeist_IntT_GarbageLine_05,P	警告 - 空調制御を無効にすると、データが破損する可能性があります。	Luke
DataHeist_IntT_GarbageLine_07,P	続行しますか Y/N - (Y)	Luke
DataHeist_IntT_IntrusionActive_Disconnect_Notify,P	! ファイアウォール作動 - 接続切断 !	Luke
DataHeist_IntT_IntrusionActive_Notify,P	! 予期しない外部接続 !	Luke
DataHeist_IntT_IntrusionNotActive_Notify,P	通知なし	Luke
DataHeist_IntT_ServerLine,P	Accessing.~mission(OverheatServerID)_cooling.disabled	Luke
DataHeist_IntT_WindowName,P	タスクマネージャー	Luke
DataHeist_SvR_Cooling_Status,P	冷却システム:	Luke
DataHeist_SvR_Cooling_Status_Off,P	無効	Luke
DataHeist_SvR_Cooling_Status_Off_Ext,P	外部端末による無効化	Luke
DataHeist_SvR_Cooling_Status_On,P	有効	Luke
DynamicEvent_FleetWeek2022_PreIFFIFound_Marker	AAコントロールの場所	-
DynamicEvent_FleetWeek2022_ReachAndWait	ホームに到着し、指示を待つ	-
Item_Desc_987_shirt_04	987のこのクラシックなタンクは、吸湿発散性に優れた素材を使用し、最もアクティブな状態でも涼しさを保つ。各シャツにはブレーサーとバンドリエが付属し、大胆でアグレッシブなスタイルを演出する。	
Jumptown2_Lawful_MBroker_desc_BlacJac	ATTN: 検証済み傭兵オペレーター\n\n最近急増した密輸品を追跡したところ、~mission(Location|Address)にある自動生産施設であることが判明した。この施設はいつまで稼働しているかわからないため、BlacJacは現場で密輸品を確保し、~mission(Destination|Address)に輸送してくれる者を必要としている。そこに着いたら、管理用商品ターミナルを使って密輸品を我々に転送し、報酬を受け取ることができる。\n\nどのような敵対勢力が存在するかは確認できていないが、どのような敵対勢力に遭遇しようとも、必要に応じて殺傷力を行使することを許可する。\n\nより多くの密輸品を持ち込めば、より多くのクレジットを得ることができる。\n\nありがとう\nアーロン・リーガート中尉\n\n個人契約スーパーバイザー\nBlacJacセキュリティ、"保護提供"\n	
Jumptown2_Lawful_MBroker_desc_CruSec	クルセイダー警備隊は、~mission(Location|Address)にある違法製造施設が現在、禁制品の製造に使用されていることを突き止めた。\n\n私たちは、この施設を警備し、禁制品を没収し、~mission(Destination|Address)に届けてくれる業者を探しています。管理用商品ターミナルで密輸品を証拠品保管所に提出し、代金を受け取ることができます。\n\nさて、ここは自動化された施設なので、どれくらいの時間製造しているのか、あるいは何人現場にいるのかも不明だ。念のため、激しい抵抗にあうことを覚悟して行くことにする。\n\n報酬の総額は、荷物がいかに安全に証拠品として届けられるかによって決まる。\n\n"契約は承認された\nヴァンザント連絡官\nID# 712L921P\n	
Jumptown2_Lawful_MBroker_desc_Hurston	ハーストン・ダイナミクス\nアウトソーシング部門\n\n契約： 密輸品の押収\n請負業者所属： 独立系\nアウトソーシング・マネージャー： T. オディントン\nリスク評価高い\n急ぎ契約：なし\n\nハーストン・セキュリティーは、~mission(Location|Address)で活動中の違法自動生産施設を発見し、現場を確保し、ハーストン・セキュリティー施設~mission(Destination|Address)に即座に廃棄するため、可能な限り多くの禁制品のパッケージを没収する請負業者を探している。禁制品の受け渡しと報酬の支払いは、そこの管理商品ターミナルを通じて行うこと。\n\nあなたは目的を達成するために必要なあらゆる武力を行使する権限を有する。報酬は確保した禁制品の量に応じて支払われる。\n\n\n\n\n** 送信された情報には、機密情報および/または特権的な情報が含まれている可能性があります。意図された受信者以外の個人または団体による、この情報のレビュー、再送信、流布、その他の使用、またはこの情報に依拠した行動は禁止されています。**\n	
Jumptown2_Lawful_MBroker_desc_MicroTech	仕事について\nマイクロテック・プロテクション・サービスでは、~mission(Location|Address)にある違法な自動生産現場から禁制品を確保するため、細部にまでこだわるセキュリティのプロフェッショナルを募集しています。パッケージはその後、~mission(Destination|Address)に運ばれ、管理商品ターミナルを経由して破壊するために私たちの所有物に転送される必要があります。\n\n責任\n- ~mission(Location|Address)までの輸送を自分で行う。\n- 敷地内で発見された敵対者を管理し、必要に応じて武力を行使する。\n- 禁制品を確保し、~mission(Destination|Address)の商品ターミナルに搬入する。\n\n最低資格\n- 2年間の傭兵経験および/または警備経験。\n- 戦闘装備と輸送手段を使用できること。\n- すぐに派遣可能な方\n\n望ましい資格\n- 迅速な敵対解除技術の経験\n	
Jumptown2_Lawful_obj_long	~mission(Location|Address)から禁制品の荷物を没収して確保し、管理商品端末を使用して~mission(Destination|Address)に届ける。	
PIT_ContractItem	契約項目 - %s	
PU_BANISTER_MG_MissionBriefs_Probe_LostReplace_IG_003_ANewBlind	グリッドに新たなブラインドスポットが出現した。探査機が墜落したようだ。私に言わせれば、少し疑わしい。通常、プローブが勝手にスイッチを切ることはない。いずれにせよ、結果は同じだ。早急に交換する必要がある走るか？	
PU_DATAHEISTSV01_F_AttentionServerOffline	注意サーバーがオフラインです。	
PU_DATAHEISTSV01_F_WarningServerOverheating	警告サーバー過熱。要注意	
PU_DATAHEISTSV01_F_WarningServerTemperature	警告サーバー温度が危険です。データ損失が迫っています。	
PU_DATAHEISTSV01_M_WarningSecurityBreach	警告セキュリティ侵害。対応チームが派遣されました。	
RetakeLocation_Neutralize_obj_02_hud	残りターゲット：~mission(targetcount)	
RetakeLocation_Neutralize_obj_03_hud	内部のターゲット：~mission(targetcountinterior)	
RetakeLocation_Neutralize_obj_04_hud	外部ターゲット：~mission(targetcountexterior)	
RetrieveConsignment_obj_03_Package_Marker	機密資料	
ShipSelector_ExpeditedFee_Label	エクスプレス料金	
ShipSelector_ExpeditedTime_Label	所要時間：��時間	
Stanton_Magnus_JPStation	Magnus ゲートウェイ	exceptur
Stanton_Magnus_JPStation_desc	ジャンプポイント近くの戦略的な場所に位置するマグナスゲートウェイは、マグナスへの往復にショップやサービスを提供しています。ステーションを訪れる人々は、以下のような様々な施設や店舗を利用することができる：燃料補給、補充、貨物輸送、個人用武器、個人用防具、食料品、クリニック、ハブスなど。	
Stanton_Pyro_JPStation	Pyro ゲートウェイ	exceptur
Stanton_Pyro_JPStation_desc	ジャンプポイント近くの戦略的な場所に位置するパイロ・ゲートウェイは、パイロを行き来する人々にショップやサービスを提供している。ステーションを訪れる人々は、以下のような様々な設備や店舗を利用することができる：燃料補給、補充、貨物輸送、個人用武器、個人用防具、衣料品、食料品、診療所、ハブスなど。	
Stanton_Terra_JPStation	Terra ゲートウェイ	exceptur
Stanton_Terra_JPStation_desc	ジャンプポイント近くの戦略的な場所に位置するTerra Gatewayは、Terraを行き来する人々にショップやサービスを提供している。ステーションを訪れる人々は、以下のような様々な設備や店舗を利用することができる：燃料補給、補充、貨物輸送、個人用武器、個人用防具、衣料品、食料品、診療所、ハブスなど。	
basesweep_MultiEliminateAll_ClearLocations_HUD_02	敵の残党を排除せよ	
basesweep_MultiEliminateSpecific_KillTargets_HUD_02	各残存ターゲットを排除する	
crusader_platform_EliminateSpecific_desc	Crusader Securityは、現在進行中のNineTailsによる襲撃に、~mission(Location|Name)に位置する著名なギャングの殺し屋が絡んでいるとの情報を入手しました。この襲撃を終結させ、責任者を司法のもとに追い詰めることは、Crusader Securityの最優先事項です。そのため、~mission(Location|Name)に向い、脅威を排除し、襲撃を主導する目標を無力化する契約業者を募集しています。\n\n現地に到着したら、~mission(TargetName)を引き出すまで、NineTailsの部隊を消耗させる必要があります。\n\n最近の襲撃でNineTailsが行使した残虐行為を考慮し、契約業者には武力行使の用意と、バックアップの検討を強くお勧めします。\n\n契約認可者:\n連絡担当官 Gibbs\nID# 91G66BW0	mossy
crusader_platform_MultiEliminateAll_description_001	最新の襲撃を受け、NineTails部隊はCrusaderの作戦を妨害し続けるため、標的を限定した襲撃を開始しました。現在の攻撃は、~mission(Location|Name)に位置する複数の建物を対象にしており、そこでの敵対行為を止めることが重要です。\n\nCrusader Securityは、その地域におけるすべてのNineTailsの作戦員を排除する契約業者を募集しています。契約業者には武力行使の用意と、バックアップの検討を強くお勧めします。\n\n契約認可者:\n連絡担当官 Bautista\nID# 948J030K	mossy
crusader_platform_MultiEliminateSpecific_desc	Crusader Securityは、現在進行中のNineTailsによる襲撃に、~mission(Location|Name)に位置するいくつかの著名なギャングの殺し屋が絡んでいるとの情報を入手しました。この襲撃を終結させ、責任者を司法のもとに追い詰めることは、Crusader Securityの最優先事項です。そのため、~mission(Location|Name)に向い、脅威を排除し、襲撃を主導する目標を無力化する契約業者を募集しています。\n\n各襲撃現場に到着したら、~mission(TargetName)を引き出すまで、それぞれNineTailsの部隊を消耗させる必要があります。\n\n最近の襲撃でNineTailsが行使した残虐行為を考慮し、契約業者には武力行使の用意と、バックアップの検討を強くお勧めします。\n\n契約認可者:\n連絡担当官 Gibbs\nID# 91G66BW0	mossy
destroyItems_BombingRunItem	液体ガス貯蔵	
dfm_ac_tut_message00	[DEBUG] Hello [~action(spaceship_hud|v_hud_confirm,?)] �capers ~image(Joypad_A.png|64|64)] world�[~action(spaceship_hud|v_hud_confirm)].	
dfm_ui_ItemFieldMultipleParam	�x%d	
dfm_ui_PlayerCommittedSuicide	自殺した！	
dfm_ui_TookTheEasyWay	楽な道を選んだ！	
dfm_ui_WarningOfflineThrusters	警告：フライトシステムがオフラインに	
dfm_ui_WarningOfflineWeapons	警告：武器はオフライン	
dfm_ui_WarningOverheatingWeapons	警告：武器�オーバーヒート	
dfm_ui_param_FracKilometres	%.*f� km	
ea_ui_StatePlayersNotReady	%d 選手の準備ができていません。\n 強制開始 %d	
ea_ui_difficulty_Easy	伍長	exceptur
ea_ui_difficulty_Hard	大佐	exceptur
ea_ui_difficulty_Normal	中尉（デフォルト）	exceptur
ea_ui_difficulty_VeryEasy	二等兵	exceptur
ea_ui_difficulty_VeryHard	Legatus Marinuum	exceptur
ea_ui_frontend_error_ReadyCheck,P	すべての選手が準備ができているわけではない	
ea_ui_matchmaking_error_MatchCycleReqMap	マッチサイクルマップリクエストに失敗しました。	
ea_ui_matchmaking_error_MatchCycleRequeue	マッチサイクルの再キューに失敗した。	
ea_ui_mode_Duel_FightOrFlight	闘争か逃走か	exceptur
ea_ui_modedesc_Duel_FightOrFlight	CitizenCon2023のアクション満載のFight x Flightトーナメントで、「ヴァース」最高のドッグファイトパイロットがコンテンツクリエイターとチームを組みます！\n2対2のドッグファイトモードで、彼らのスキルとチームワークが試されます。	
ea_ui_patchnotes_version	パッチノート	exceptur
ea_ui_reward_ExperimentalPlayed_Msg	このエクスペリメンタル・モードをプレイしていただきありがとうございます！このパッチをすべてプレイすると、特別なバッジがアンロックされます！	
elevator_accessing	中央�輸送システムへのアクセス	
itemPort_port_Bomb_System,P	[PH] port_Bomb_System	
itemPort_port_Flair01	フレアアイテム1	
itemPort_port_Flair02	フレアアイテム2	
item_DescCutter_Paint_Black_Cyan	ナイトフォールのカラーリングは、カッターをシアン色のポップで洗練されたブラックに塗装している。	
item_DescCutter_Paint_Olive_White_Orange	緑と白にオレンジのハイライトが入ったカイマンのカラーリングは、カッターに独特のドラマチックな外観をもたらす。	
item_DescCutter_Paint_Orange_Grey_Stripe	オレンジのストライプとブラウンのハイライトがグレーの船体を引き立てるRockslideカラーリングで、カッターにユニークなスタイルをもたらします。	
item_DescDragonfly_Paint_Citcon2953_Beige_Tan_Beige	このカラーリングのバージョンは、オリジナルの形から変更されている。パイロ発見400周年を記念して2893年に発売されたルスタバウトのカラーリングは、その外観と名前が、この星系への最初のジャンプポイントの発見につながった船の名前に由来している。また、この星系を命名した今はなき鉱山会社Pyrotechnic Amalgamatedのロゴも描かれている。	
item_DescFlair_Coin_1_f	量子ドライブを搭載した初の民間宇宙船、RSIゼウスに敬意を表して作られたコイン。コインの片面には歴史的な探査機が描かれ、もう片面にはロバーツ・スペース・インダストリーズのロゴが浮き彫りにされている。	
item_DescFlair_Model_HullC_2_takuetsu_box	タクエツのハルCモデルのコレクターズ・エディション・ボックス。前面には象徴的な船のイメージとモデルの詳細が描かれている。	
item_DescFlair_Poster_HT_BIS_1_a	ドレーク・インタープラネタリー社の頑丈な難破船バルチャー号が、2953シップ・ショーダウンでベスト4に進出したことを祝して、飛行中のバルチャー号のポスターをプレゼント。	
item_DescFlair_Poster_HT_BIS_1_b	コルセア号、2953艦船対決優勝おめでとう。このポスターは、この象徴的で非対称なドレイク・インタープラネタリー艦の勝利を祝うものです。	
item_DescFlair_Poster_HT_BIS_1_c	イージスダイナミクスのレディーマーが2953年艦船対決のファイナル4に進出したことを記念したポスター。この船はただ生き残るだけでなく、その自然環境、つまり戦闘の熱気の中で繁栄している様子をとらえている。	
item_DescFlair_Poster_HT_BIS_1_d	洗練されたスタイルと最先端技術を融合させたOriginの600iが、2953年のシップ・ショーダウンでベスト4入りを果たした理由は容易に理解できる。このポスターは、このマルチロール・ラグジュアリー・ライナーが雲を突き抜けていくイメージで、その偉業を称えています。	
item_DescPlushy_zeus_1_a	このソフトなぬいぐるみは、量子ドライブを搭載した初の民間宇宙船、2140年型RSIゼウスを讃える、抱きしめられる歴史の断片である。	
item_DescSpirit_A1_Paint_Green_Black_Orange	マットなモスグリーンにダスティオレンジのハイライトとアクセントのストライプをあしらったこのカラーリングは、あなたのクルセイダースピリットを注目の的とする。	
item_DescSpirit_Paint_Black_Blue_White	ダークグレーにスカイブルーのハイライトとホワイトのトリミングをあしらったこのカラーリングは、あなたのクルセイダースピリットをどこまでも引き立てます。	
item_DescSpirit_Paint_Grey_Grey_Blue	グレーのボディにスチール・ブルーのトリムをあしらったこの繊細なカラーリングは、クルセイダー・スピリットに一目置かれること請け合いだ。	
item_DescSpirit_Paint_Maroon_Beige_Blue	このカラーリングの深い赤は、クルセイダースピリットのすでに大胆なラインを強調し、トープとネイビーの繊細なハイライトがさらに華やかさを与えている。	
item_DescSpirit_Paint_White_Blue_Black	クリーンなホワイトのパネルに紺碧の縁取りが施されたこのカラーリングは、クルセイダースピリットのルックスを次のレベルに引き上げる。	
item_Desc_CDS_Undersuit_Armor_02_Shared	アイテムタイプアンダースーツ\nダメージ軽減10%\n温度レーティング: -30 / 60 �C\n\nFBL-8uはCDS初のオーブ織り技術を採用したアンダースーツです。FBL-8uはCDSのFBL-8aライトアーマーと組み合わせるために開発されました。	
item_Desc_CDS_Undersuit_Armor_Shared	アイテムタイプアンダースーツ\nダメージ軽減10%\n温度レーティング: -30 / 60 �C\n\nこの包括的なタクティカル・コンバット・スーツは、真空に対する完全な密閉スーツを提供し、自由な可動域を確保し、互換性のあるアーマー・システムとシームレスにインターフェースします。	
item_Desc_GRIN_utility_medium_arms_01	アイテムタイプミディアム・アーマー\nダメージ軽減30%\n温度レート: -61 / 91 �C\n \n元々鉱夫のためにデザインされたアリルのアーマーには、完全に密閉されたヘルメットと高い襟があり、首と後頭部をサポートし保護します。ツールベルトとバックパックが一体化し、様々なツールや消耗品を収納できるため、両手が自由に使えます。アリルアーマーは、好みに合わせて、また現場で識別しやすいように、鮮やかなカラーバリエーションが用意されている。	
item_Desc_GRIN_utility_medium_backpack_01	アイテムタイプミディアムバックパック\nキャリー容量： 85K �SCU\nコアの互換性ミディアム	
item_Desc_GRIN_utility_medium_backpack_02	アイテムタイプミディアムバックパック\n容量： 85K �SCU\nコアの互換性アリルコアオンリー\n\nアリルコレクターバックパックなら、満載の荷物も楽に持ち運べます。超堅牢な工業デザインは、グレイキャットのアリルのアーマーセットのために特別に作られた。人間工学に基づいたサポートが特徴で、背中にかかる重さを均等に分散し、アイテムを安全かつ確実に保護します。沈没船のサルベージ、鉱山への立ち入り、単なる用事など、アリルコレクターは普段使いに最適です。	
item_Desc_GRIN_utility_medium_core_01	アイテムタイプミディアム・アーマー\nダメージ軽減30%\nキャリー容量：15k�SCU\n温度定格温度： -61 / 91\nバックパックとの互換性ライト	
item_Desc_GRIN_utility_medium_helmet_01	アイテムタイプミディアム・アーマー\nダメージ軽減30%\n温度レート: -61 / 91 �C\n \n元々鉱夫のためにデザインされたアリルのアーマーには、完全に密閉されたヘルメットと高い襟があり、首と後頭部をサポートし保護します。ツールベルトとバックパックが一体化し、様々なツールや消耗品を収納できるため、両手が自由に使えます。アリルアーマーは、好みに合わせて、また現場で識別しやすいように、鮮やかなカラーバリエーションが用意されている。	
item_Desc_GRIN_utility_medium_legs_01	アイテムタイプミディアム・アーマー\nダメージ軽減30%\nキャリー容量：10K�SCU\n温度定格温度： -61 / 91\n \n鉱山労働者用に開発されたアリールアーマーは、完全密閉型のヘルメットと高い襟により、首と後頭部を保護します。ツールベルトとバックパックが一体化し、様々なツールや消耗品を収納できるため、両手が自由に使えます。アリルアーマーは、好みに合わせて、また現場で識別しやすいように、鮮やかなカラーバリエーションが用意されている。	
item_Desc_SRVL_parasite_helmet_01	アイテムタイプフライト・ヘルメット\nダメージ軽減10%\n温度レーティング: -30 / 60 �C\n\nオリジナルのパラサイトヘルメットは新たな恐怖の顔を確立し、帝国を恐怖に陥れた。CC'sコンバージョンズのパラサイトレプリカヘルメットで、この象徴的な顔があなたのものになります。オリジナルの小道具をデジタルスキャンして、ぞっとするような細部まで再現しました。その独特なデザインにもかかわらず、パラサイト・レプリカ・ヘルメットは宇宙仕様で、完全に機能します。大気圏内でも大気圏外でも、誰かを怖がらせたい場所ならどこでも安全に着用できる。	
item_Desc_SRVL_parasite_helmet_02	アイテムタイプフライト・ヘルメット\nダメージ軽減10%\n温度レーティング: -30 / 60 �C\n\n帝国に衝撃を与えたオリジナルVTRから7年：ダーク・バース』は新たな恐怖をもたらした。CC'sコンバージョンズでは、最新作の発売を記念して、ビデオ制作者とのコラボレーションによる公式レプリカヘルメットを製作しました。パラサイトの目に内蔵された特殊なセンサーにより、細部に至るまで恐ろしい反応をはっきりと見ることができる。オリジナルのプロップに敬意を表し、宇宙旅行の実際の厳しさに耐えるよう慎重に設計されたこのヘルメットは、あなたを歩く悪夢に変えるプレミア・レプリカだ！	
item_Desc_Slaver_Undersuit_Armor_Shared	アイテムタイプアンダースーツ\nダメージ軽減10%\n温度レーティング: -30 / 60 �C\n\nKastak Armsの戦闘用アンダースーツStoneskinシリーズは、CDSの有名なTCS-4システムをベースに構築されています。	
item_Desc_alb_mask_03_01_01	過酷な環境のために作られたSalluqマスクは、広い視野を提供しながら、あなたの目から汚れ、ほこり、砂塵を防ぎます。このマスクは宇宙用ではないので、通気性のある環境でのみ着用してください。	
item_Desc_alb_pants_03	アドベンチャー・ビジネスに携わるなら、暑さに耐えられるウェアが必要だ。このオールパ・パンツはアレホフレックス・テクノロジーを採用したヘビーウェイト・コットンで作られており、耐久性を維持しながらタフな作業中も着用者に広い可動域を提供する。	
item_Desc_cbd_hat_03_cvx01_01	フロントパネルとバックパネルにコバレックスの名前とロゴが刺繍された黒のカデット帽。	
item_Desc_cbd_hat_03_itg_01	星間輸送ギルドの名前とロゴがフロントパネルとバックパネルに刺繍された青と黒のカデットハット。	
item_Desc_cbd_hat_03_ling_01	リン・ファミリー・ホーリングの名前とロゴがフロントパネルとバックパネルに刺繍された赤と白のカデットハット。	
item_Desc_cbd_hat_03_redwind_01	グレーのカデット帽で、フロントパネルとバックパネルにレッドウインド・リネホールの名前とロゴが刺繍されている。	
item_Desc_cbd_hat_03_taba_01	フロントとバックパネルにTABAフレイトラインの名前とロゴが刺繍された黒と白のカデットハット。	
item_Desc_cbd_hat_03_unified_01	ユニファイド・ディストリビューション・マネジメントの名前とロゴがフロントパネルとバックパネルに刺繍された青と赤のカデット帽。	
item_Desc_cbd_pants_05	柔らかくも丈夫なコットンで作られたこのジーンズは、裂けてからカラフルな糸で "修理 "され、不格好なパッチとともに歴史を感じさせる。	
item_Desc_ccc_bear_helmet_01_01_01	アイテムタイプフライト・ヘルメット\nダメージ軽減10%\n温度レート: -40 / 60 �C\n\nフィールズベリー・ダークベアのヘルメット。フィールズベリーのマスコット、ダークベアは、ソーダの季節限定フレーバーとして発売された後、悪ふざけで有名になりました。それ以来、このクマの大きな歯を見せて笑う姿と、その瞳の明滅は、ヴァーラの日のお祝いの定番光景となっている。今回、CC's Conversionsは、この象徴的なマスコットを公式の高品質複製品としてデザインし、6色の印象的なカラーでお届けします。	
item_Desc_ccc_heavy_armor_helmet_01	アイテムタイプヘビーアーマー\nダメージ軽減40%\n温度レーティング: -80 / 110 �C\n\nネオニ・ヘルメットで主君に仕えないことを示せ。モンスター神話や古代の戦士文化からインスピレーションを得たCC's Conversionsのこの威嚇的なビサージュは、ドラマチックなペイント、牙を生やした笑み、尖ったホログラフィックホーンが特徴です。	
item_Desc_ccc_medium_armor_arms_01_01_01	アイテムタイプミディアム・アーマー\nダメージ軽減30%\n温度レート: -61 / 91 �C\n\nテバリンの美学を体現するアヴェスアーマー。最先端の製造技術を駆使し、白、赤、グレー、黒のメッキを人間の体型に完璧にフィットさせ、テバリンの象徴である船の形状言語を想起させます。このCC's Conversionsのミディアムアーマーは、センセーショナルかつ実用的で、しっかりとしたプロテクションを提供しながらも、軽快な足取りを保つことができる。アヴェス・ヘルメットと組み合わせれば、印象的で忘れられないルックスに。	
item_Desc_ccc_medium_armor_arms_01_01_shrike	アイテムタイプミディアム・アーマー\nダメージ軽減30%\n温度レート: -61 / 91 �C\n\nホワイト、ブルー、マゼンタ、グレー、ブラックのメッキが施され、テバリンの象徴的な船型を完璧に彷彿とさせる。このCC's Conversionsのミディアムアーマーは、センセーショナルかつ実用的で、しっかりとしたプロテクションを提供しながらも、身軽さを保つことができる。アヴェス・シュライク・ヘルメットと組み合わせれば、印象的で忘れられないルックスに。	
item_Desc_ccc_medium_armor_arms_01_01_talon	アイテムタイプミディアム・アーマー\nダメージ軽減30%\n温度レート: -61 / 91 �C\n\nホワイト、ブルー、マゼンタ、グレー、ブラックのメッキが施され、テバリンの象徴である船の形状を見事に表現している。このCC's Conversionsのミディアムアーマーは、センセーショナルかつ実用的で、しっかりとしたプロテクションを提供しながらも、身軽さを保つことができる。アヴェス・タロン・ヘルメットと組み合わせれば、印象的で忘れられないルックに。	
item_Desc_ccc_medium_armor_core_01_01_01	アイテムタイプミディアム・アーマー\nダメージ軽減30%\nキャリー容量：7.5k�SCU\n温度定格温度：-61 / 91\nバックパックとの互換性ライト	
item_Desc_ccc_medium_armor_core_01_01_shrike	アイテムタイプミディアム・アーマー\nダメージ軽減30%\nキャリー容量：7.5k�SCU\n温度定格温度：-61 / 91\nバックパックとの互換性ライト	
item_Desc_ccc_medium_armor_core_01_01_talon	アイテムタイプミディアム・アーマー\nダメージ軽減30%\nキャリー容量：7.5k�SCU\n温度定格温度：-61 / 91\nバックパックとの互換性ライト	
item_Desc_ccc_medium_armor_helmet_01	アイテムタイプミディアム・アーマー\nダメージ軽減30%\n温度レーティング: -60 / 90 �C\n\nCC'sコンバージョンズは、テバリン文化の美しくユニークな歴史を称えるために、エイヴスをリリースすることを誇りに思っています。このミディアムヘルメットは伝統的なスタイルを尊重しながらも、人間の頭に完璧にフィットします。赤のハイライトが黒と白のメッキにカラフルで鮮やかなアクセントを与え、この偉大な種族にふさわしい大胆でダイナミックな雰囲気を醸し出しています。	
item_Desc_ccc_medium_armor_helmet_01_01_shrike	アイテムタイプミディアム・アーマー\nダメージ軽減30%\n温度レーティング: -60 / 90 �C\n\nCC'sコンバージョンズから、テバリン文化の美しくユニークな歴史を称えるアヴェス・シュライクのヘルメットが登場。このミディアムヘルメットは伝統的なスタイルを尊重し、黒と白のメッキにカラフルなブルーとマゼンタのアクセントを加え、この偉大な種族にふさわしい大胆でダイナミックな雰囲気を醸し出している。	
item_Desc_ccc_medium_armor_helmet_01_01_talon	アイテムタイプミディアム・アーマー\nダメージ軽減30%\n温度レーティング: -60 / 90 �C\n\nCC'sコンバージョンズは、テバリン文化の美しくユニークな歴史を称えるために、エイヴス・タロン・ヘルメットをリリースすることを誇りに思っています。このミディアムヘルメットは伝統的なスタイルを尊重し、黒と白のメッキにカラフルなグリーンのアクセントを加え、この偉大な種族にふさわしい大胆でダイナミックな雰囲気を醸し出している。	
item_Desc_ccc_medium_armor_legs_01_01_01	アイテムタイプミディアム・アーマー\nダメージ軽減30%\nキャリー容量：4.5K�SCU\n温度定格温度：-61 / 91\n\nテバリンの美学を体現するアヴェスアーマー。最先端の製造技術を駆使し、白、赤、グレー、黒のメッキを人間の体型に完璧にフィットさせ、テバリンの象徴である船の形状言語を想起させます。このCC's Conversionsのミディアムアーマーは、センセーショナルかつ実用的で、しっかりとしたプロテクションを提供しながらも、軽快な足取りを保つことができる。アヴェス・ヘルメットと組み合わせれば、印象的で忘れられないルックスに。	
item_Desc_ccc_medium_armor_legs_01_01_shrike	アイテムタイプミディアム・アーマー\nダメージ軽減30%\nキャリー容量：4.5K �SCU\n温度定格温度：-61 / 91\n\nホワイト、ブルー、マゼンタ、グレー、ブラックのメッキが施されたアーマーは、テバリンの美学を体現しています。CC'sコンバージョンズのこのミディアムアーマーは、センセーショナルかつ実用的で、機動性を犠牲にすることなく強固なプロテクションを提供する。アヴェス・シュライク・ヘルメットと組み合わせれば、印象的で忘れられないルックスに。	
item_Desc_ccc_medium_armor_legs_01_01_talon	アイテムタイプミディアム・アーマー\nダメージ軽減30%\nキャリー容量：4.5K �SCU\n温度定格温度：-61 / 91\n\nホワイト、ブルー、マゼンタ、グレー、ブラックのメッキが施され、テバリンの象徴的な艦船を彷彿とさせます。このCC's Conversionsのミディアムアーマーは、センセーショナルかつ実用的で、機動性を犠牲にすることなく強固なプロテクションを提供する。アヴェス・タロン・ヘルメットと組み合わせれば、印象的で忘れられないルックスに。	
item_Desc_ccc_scarecrow_helmet_01_01_01	アイテムタイプフライト・ヘルメット\nダメージ軽減10%\n温度レーティング: -30 / 60 �C\n\n有名な連続殺人鬼ネビル・ロットの恐ろしい外見にインスパイアされたヘルメットで友達を悩殺しよう。スラッシャー映画の名作「ヒル・ホラー」によって、このヘルメットは「バラの日」フェスティバルの定番となりました。ヒル・ホラーのヘルメットは、様々な環境条件に耐えることができる特別な仕上げで密封された実際のガニー・サックで作られており、快適なスペース・レートのヘルメットを覆っている。このヘルメットで歩く悪夢となり、不吉なスタイルでヴァーラの日を祝おう。	
item_Desc_ccc_scarecrow_helmet_01_01_12	アイテムタイプフライト・ヘルメット\nダメージ軽減10%\n温度レーティング: -30 / 60 �C\n\n人気スラッシャー映画「ザ・ヒル・ホラー・リボーン」に登場する恐怖のヘルメットを、カスタムメイドでハイクオリティに再現。悪名高い連続殺人鬼ネビル・ロットの恐ろしい外見にインスパイアされたこのコレクターズ・エディションの宇宙安全ヘルメットは、黒いガニーサックとネオングリーンのライトで、シリーズ2作目のビデオに登場する殺人鬼の外見を再現している。不吉なスタイルで「ヴァーラの日」を祝おう。	
item_Desc_ccc_vanduul_helmet_01_01_01	アイテムタイプフライト・ヘルメット\nダメージ軽減10%\n温度レーティング: -30 / 60 �C\n\n唸るヴァンドゥールヘルメットで、CC's Conversionsは特別な宇宙時代の加硫シリコンゴムを開発し、ヴァンドゥールの威嚇的な微笑みから後頭部の隆起まで再現しました。軽量のフライトヘルメットの上に成型されたこのヴァンドゥールビサージュは、大気圏内でも大気圏外でも着用可能で、ヴァーラの日を祝う場所ならどこでも究極の宇宙侵略者になれる。	
item_Desc_cds_armor_light_arms_02_shared	アイテムタイプライトアーマー\nダメージ軽減率: 20%\n温度レーティング: -35 / 65 �C\n\nCDSの理想的なライトアーマーを追求したFBL-8a。このライトアーマーは戦略的な保護メッキと強化ナノ織りファブリックのミックスにより、素早い立ち回りを可能にする。FBL-8uのアンダースーツとの相性は抜群で、特にFBL-8uのアンダースーツとの相性は抜群で、FBL-8uのアンダースーツとの相性は抜群である。	
item_Desc_cds_armor_light_core_02_shared	アイテムタイプライトアーマー\nダメージ軽減率：20\n携帯能力：4K�SCU\n温度定格温度：-32 / 62\nバックパック互換性ライト\n\nFBL-8aは、CDSの理想的なライトアーマーを追求したモデルです。プロテクションメッキと強化ナノウィーブファブリックを戦略的にミックスさせたこのライトアーマーは、素早い立ち回りを可能にする。FBL-8uとFBL-8uのマッチングに特別な配慮がされている。	
item_Desc_cds_armor_light_legs_02_shared	アイテムタイプライトアーマー\nダメージ軽減率：20\nキャリー容量：2.5K �SCU\n温度定格温度：-35 / 65\n\nCDSの理想的なライトアーマーを追求したFBL-8a。このライトアーマーは戦略的なメッキと補強されたナノウィーブファブリックの組み合わせにより、素早い立ち回りを可能にする。FBL-8uのアンダースーツとの相性は抜群で、特にFBL-8uのアンダースーツとの相性は抜群で、FBL-8uのアンダースーツとの相性は抜群である。	
item_Desc_cds_armor_medium_arms_01_01_9tails01	アイテムタイプミディアム・アーマー\nダメージ軽減30%\n温度レート: -61 / 91 �C\n\nCDSのORC-mkXアーマーを改良したバージョン。マークXはCDS�の受賞歴のあるオムニロールコンバットアーマーシリーズの最新作です。このEVA規格のスーツは、新しいEdgeCoreコンポジットウィーブテクノロジーを採用し、オペレーターの敏捷性を最小限に抑えながら、投射物、爆発物、要素からの保護を最大化します。	
item_Desc_cds_armor_medium_legs_02_9tails_01	アイテムタイプミディアム・アーマー\nダメージ軽減30%\nキャリー容量：4.5K �SCU\n温度定格温度：-61 / 91\n\nCDSのORC-mkXの脚部を改良したバージョン。マークXは、数々の賞を受賞したCDSのオムニロールコンバットアーマーシリーズの最新作です。このEVA規格のスーツは、新しいEdgeCoreコンポジットウィーブテクノロジーを採用し、オペレーターの敏捷性を最小限に抑えながら、投射物、爆発物、要素に対するプロテクションを最大限に高めています。	
item_Desc_cds_combat_heavy_backpack_01_01_01	アイテムタイプヘビーバックパック\n耐荷重： 100K �SCU\nコア適合性：ヘビー\n\nどんな状況にも対応できるCSP-68Hバックパック。もともと戦闘支援用に設計されたこのヘビーバックパックは、その耐久性と、CSP-68Hが快適に背中にバランスよく収まるようサポートする特許取得のコアコネクターにより、人気を博しています。	
item_Desc_cds_combat_light_arms_03	アイテムタイプライトアーマー\nダメージ軽減率: 20%\n温度レーティング: -35 / 65 �C\n\nCDSのFBL-8aコンバットアーマーをベースに改良されたアーマー。戦略的なメッキと強化ナノ織りファブリックの組み合わせにより、素早い立ち回りを可能にするライトアーマー。FBL-8uのアンダースーツとのマッチングを考慮した設計。	
item_Desc_cds_combat_light_arms_04	アイテムタイプライトアーマー\nダメージ軽減率: 20%\n温度レーティング: -35 / 65 �C\n\nCDSのFBL-8aコンバットアーマーをベースに改良されたアーマー。戦略的なメッキと強化ナノ織りファブリックの組み合わせにより、素早い立ち回りを可能にするライトアーマー。FBL-8uのアンダースーツとのマッチングを考慮した設計。	
item_Desc_cds_combat_light_backpack_01_01_01	アイテムタイプライトバックパック\n容量： 40K �SCU\nコアの互換性すべて\n\nCSP-68Lバックパックがあれば、どんな状況にも対応できます。もともと戦闘支援用に設計されたこの軽量バックパックは、その耐久性と、CSP-68Lが快適に背中にバランスよく収まるようサポートする特許取得のコアコネクターにより、人気を博しています。	
item_Desc_cds_combat_light_backpack_02_01_01	アイテムタイプライトバックパック\n容量： 40K �SCU\nコアの互換性すべて\n\nCSP-68Lバックパックがあれば、どんな状況にも対応できます。CSP-68Lは元々戦闘支援用に設計された軽量バックパックですが、その耐久性と特許取得済みのコアコネクターにより、背負った時の快適さとバランスの良さで人気を博しています。ケイマン・エディションは、幾何学模様の鮮やかなメタリック・グリーン仕上げで、照明条件によって微妙に変化するカラーが特徴です。	
item_Desc_cds_combat_light_backpack_02_02_01	アイテムタイプライトバックパック\n容量： 40K �SCU\nコアの互換性すべて\n\nCSP-68Lバックパックがあれば、どんな状況にも対応できます。CSP-68Lは元々戦闘支援用に設計された軽量バックパックですが、その耐久性と特許取得のコアコネクターにより、背負った時の快適なバランスで人気を博しています。フォレストカモエディションは、シルバーのハイライトが入った特別なデジタルグリーンカモ柄が特徴です。	
item_Desc_cds_combat_light_backpack_02_03_01	アイテムタイプライトバックパック\n容量： 40K �SCU\nコアの互換性すべて\n\nCSP-68Lバックパックがあれば、どんな状況にも対応できます。CSP-68Lはもともと戦闘支援用に設計された軽量バックパックで、その耐久性と特許取得済みのコアコネクターにより、背中にバランスよく快適に装着できることで人気を博しています。ナイトカモ・エディションは、特別なテクスチャー仕上げが特徴で、ブラックカモとシルバーをミックスし、さりげなくも印象的な外観に仕上げている。	
item_Desc_cds_combat_light_core_03	アイテムタイプライトアーマー\nダメージ軽減率：20\n携帯能力：4K�SCU\n温度定格温度：-32 / 62\nバックパック互換性ライト\n\nCDSのFBL-8aコンバットアーマーをベースに改良を加えたセット。戦略的なメッキと強化ナノ織りファブリックの組み合わせにより、素早い立ち回りを可能にするライトアーマー。FBL-8uのアンダースーツとのマッチングを考慮した設計。	
item_Desc_cds_combat_light_core_04	アイテムタイプライトアーマー\nダメージ軽減率：20\n携帯能力：4K�SCU\n温度定格温度：-32 / 62\nバックパック互換性ライト\n\nCDSのFBL-8aコンバットアーマーをベースに改良を加えたセット。戦略的なメッキと強化ナノ織りファブリックの組み合わせにより、素早い立ち回りを可能にするライトアーマー。FBL-8uのアンダースーツとのマッチングを考慮した設計。	
item_Desc_cds_combat_light_helmet_03	アイテムタイプライトアーマー\nダメージ軽減率: 20%\n温度レーティング: -35 / 65 �C\n\nCDSのFBL-8aコンバットアーマーをベースに改良されたアーマー。戦略的なメッキと強化ナノ織りファブリックの組み合わせにより、素早い立ち回りを可能にするライトアーマー。FBL-8uのアンダースーツとのマッチングを考慮した設計。	
item_Desc_cds_combat_light_helmet_04	アイテムタイプライトアーマー\nダメージ軽減率: 20%\n温度レーティング: -35 / 65 �C\n\nCDSのFBL-8aコンバットアーマーをベースに改良されたアーマー。戦略的なメッキと強化ナノ織りファブリックの組み合わせにより、素早い立ち回りを可能にするライトアーマー。FBL-8uのアンダースーツとのマッチングを考慮した設計。	
item_Desc_cds_combat_light_legs_03	アイテムタイプライトアーマー\nダメージ軽減率：20\nキャリー容量：2.5K �SCU\n温度定格温度：-35 / 65\n\nCDSのFBL-8aコンバットアーマーをベースに改良されたアーマー。戦略的なメッキと補強されたナノ織りファブリックにより、素早い立ち回りを可能にするライトアーマー。FBL-8uのアンダースーツとのマッチングを考慮した設計。	
item_Desc_cds_combat_light_legs_04	アイテムタイプライトアーマー\nダメージ軽減率：20\nキャリー容量：2.5K �SCU\n温度定格温度：-35 / 65\n\nCDSのFBL-8aコンバットアーマーをベースに改良されたアーマー。戦略的なメッキと補強されたナノ織りファブリックにより、素早い立ち回りを可能にするライトアーマー。FBL-8uのアンダースーツとのマッチングを考慮した設計。	
item_Desc_cds_combat_medium_arms_03_01_01	アイテムタイプミディアム・アーマー\nダメージ軽減30%\n温度レート: -61 / 91 �C\n\nCDSのORC-mkXコンバットアーマーを改良したバージョン。マークXはCDS�の受賞歴のあるオムニロールコンバットアーマーシリーズの最新作です。このEVA規格のスーツは、新しいEdgeCoreコンポジットウィーブテクノロジーを採用し、オペレーターの敏捷性を最小限に抑えながら、投射物、爆発物、要素に対する保護力を最大限に高めています。	
item_Desc_cds_combat_medium_arms_04_01_01	アイテムタイプミディアム・アーマー\nダメージ軽減30%\n温度レート: -61 / 91 �C\n\nCDSのORC-mkXコンバットアーマーを改良したバージョン。マークXはCDS�の受賞歴のあるオムニロールコンバットアーマーシリーズの最新作です。このEVA規格のスーツは、新しいEdgeCoreコンポジットウィーブテクノロジーを採用し、オペレーターの敏捷性を最小限に抑えながら、投射物、爆発物、要素に対する保護力を最大限に高めています。	
item_Desc_cds_combat_medium_backpack_01_01_01	アイテムタイプミディアムバックパック\n容量： 70K �SCU\nコアの互換性ミディアム	
item_Desc_cds_combat_medium_core_03_01_01	アイテムタイプミディアム・アーマー\nダメージ軽減30%\nキャリー容量：7.5k�SCU\n温度定格温度：-61 / 91\nバックパックとの互換性ライト	
item_Desc_cds_combat_medium_core_04_01_01	アイテムタイプミディアム・アーマー\nダメージ軽減30%\nキャリー容量：7.5k�SCU\n温度定格温度：-61 / 91\nバックパックとの互換性ライト	
item_Desc_cds_combat_medium_helmet_03_01_01	アイテムタイプミディアム・アーマー\nダメージ軽減30%\n温度レーティング: -61 / 93 �C\n\nCDSのコンバットアーマーORC-mkXのオリジナルバージョン。マークXはCDS�の受賞歴のあるオムニロールコンバットアーマーシリーズの一部です。このEVA規格のスーツは、新しいEdgeCoreコンポジットウィーブテクノロジーを採用しており、オペレーターの敏捷性を最小限に抑えながら、投射物、爆発物、要素に対する防護を最大化します。"	
item_Desc_cds_combat_medium_helmet_04_01_01	アイテムタイプミディアム・アーマー\nダメージ軽減30%\n温度レーティング: -61 / 93 �C\n\nCDSのコンバットアーマーORC-mkXのオリジナルバージョン。マークXはCDS�の受賞歴のあるオムニロールコンバットアーマーシリーズの一部です。このEVA規格のスーツは、新しいEdgeCoreコンポジットウィーブテクノロジーを採用し、オペレーターの敏捷性を最小限に抑えながら、投射物、爆発物、要素に対する保護性能を最大限に高めています。	
item_Desc_cds_combat_medium_legs_03_01_01	アイテムタイプミディアム・アーマー\nダメージ軽減30%\nキャリー容量：4.5K �SCU\n温度定格温度：-61 / 91\n\nCDSのORC-mkXコンバットアーマーをベースに改良を加えたバージョン。マークXは、数々の賞を受賞したCDSのオムニロールコンバットアーマーシリーズの一つです。このEVA規格のスーツは、新しいEdgeCoreコンポジットウィーブテクノロジーを採用し、オペレーターの敏捷性を最小限に抑えながら、投射物、爆発物、要素に対する保護力を最大限に高めています。	
item_Desc_cds_combat_medium_legs_04_01_01	アイテムタイプミディアム・アーマー\nダメージ軽減30%\nキャリー容量：4.5K �SCU\n温度定格温度：-61 / 91\n\nCDSのORC-mkXコンバットアーマーをベースに改良を加えたバージョン。マークXは、数々の賞を受賞したCDSのオムニロールコンバットアーマーシリーズの一つです。このEVA規格のスーツは、新しいEdgeCoreコンポジットウィーブテクノロジーを採用し、オペレーターの敏捷性を最小限に抑えながら、投射物、爆発物、要素に対する保護力を最大限に高めています。	
item_Desc_cds_heavy_armor_01_Shared	アイテムタイプヘビーアーマー\nダメージ軽減40%\n温度レーティング: -70 / 100 �C\n\n困難な任務が待ち受けているとき、最後までやり遂げられるようにしたいものです。クラーク・ディフェンス・システムズのADP-mk4ヘビーアーマーは、海兵隊員がより長い時間、より多くの装備オプションで活発な戦闘状況にとどまることを可能にし、そのパワードフレームは、それが提供する保護にもかかわらず、ほぼ自由な動きを提供します。	
item_Desc_cds_heavy_armor_01_concierge_Shared	アイテムタイプヘビーアーマー\nダメージ軽減40%\n温度レーティング: -70 / 100 �C\n\n困難な任務が目の前に迫っているとき、それを最後まで確実にやり遂げたいものです。クラーク・ディフェンス・システムズのADP-mk4ヘビーアーマーは、海兵隊員がより長い時間アクティブな戦闘状況にとどまることを可能にし、より多くのロードアウトオプションを提供します。このエグゼクティブ・エディションは、六角形のパターンがはめ込まれたブラッシュドクローム仕上げが特徴。	
item_Desc_cds_heavy_armor_01_concierge_core	アイテムタイプヘビーアーマー\nダメージ軽減40%\nキャリー容量：10.5k�SCU\n温度定格温度：-70 / 100\nバックパックとの互換性すべて\n\n困難な任務が待ち受けているとき、最後まで確実に任務を遂行したいものです。クラーク・ディフェンス・システムズのADP-mk4ヘビーアーマーは、海兵隊員がより長い時間アクティブな戦闘状況にとどまることを可能にし、より多くのロードアウトオプションを提供します。このエグゼクティブ・エディションは、六角形のパターンがはめ込まれたブラッシュドクローム仕上げが特徴。	
item_Desc_cds_heavy_armor_01_concierge_legs	アイテムタイプヘビーアーマー\nダメージ軽減40%\nキャリー容量：6.5k�SCU\n温度定格温度：-70 / 100\n\n困難な任務が待ち受けているとき、最後まで確実に任務を遂行したいものです。クラーク・ディフェンス・システムズのADP-mk4ヘビーアーマーは、海兵隊員がより長い時間、より多くの装備オプションでアクティブな戦闘状況にとどまることを可能にし、そのパワードフレームは、保護されているにもかかわらず、ほぼ自由な動きを提供します。このエグゼクティブ・エディションは、六角形のパターンがはめ込まれたブラッシュドクローム仕上げが特徴。	
item_Desc_cds_heavy_armor_01_core	アイテムタイプヘビーアーマー\nダメージ軽減40%\nキャリー容量：10.5k�SCU\n温度定格温度：-70 / 100\nバックパックとの互換性すべて\n\n困難な任務が待ち受けているとき、最後まで確実に任務を遂行したいものです。クラーク・ディフェンス・システムズのADP-mk4ヘビーアーマーは、海兵隊員がより長い時間、より多くの装備オプションでアクティブな戦闘状況に留まることを可能にします。	
item_Desc_cds_heavy_armor_01_legs	アイテムタイプヘビーアーマー\nダメージ軽減40%\nキャリー容量：6.5k�SCU\n温度定格温度：-70 / 100\n\n困難な任務が待ち受けているとき、最後まで確実に任務を遂行したいものです。クラーク・ディフェンス・システムズのADP-mk4ヘビーアーマーは、海兵隊員がより長い時間、アクティブな戦闘状況にとどまることを可能にする。	
item_Desc_cds_legacy_armor_heavy_arms_01_9tails_01	アイテムタイプヘビーアーマー\nダメージ軽減40%\n温度レーティング: -75 / 105 �C\n\nCDSのADPアーマーを改良したバージョン。ADPヘビーアーマーシステムは発売当初、革命的な防具として注目を集めました。クラーク・ディフェンス・システムズのマキシマリスト・デザインは、豊富なアタッチメント・ポイントを備え、風雨や敵の攻撃から身を守る。CDSは長年にわたってADPラインを改良し、形を変えてきたが、多くの人はまだオリジナルのADPを軍用重装甲の試金石と考えている。	
item_Desc_cds_legacy_armor_heavy_arms_01_crus01_01	アイテムタイプヘビーアーマー\nダメージ軽減40%\n温度レーティング: -75 / 105 �C\n\nADPヘビーアーマーシステムは、発売当初は画期的な防具として注目を集めました。クラーク・ディフェンス・システムズの最大主義的なデザインは、多くの取り付けポイントを提供し、要素や敵の砲火に対する優れた保護を提供します。CDSは長年にわたってADPラインを改良し、形を変えてきたが、多くの人はいまだにオリジナルのADPをミリタリーグレードのヘビーアーマーの試金石と考えている。クルセイダー・エディションは、同社のセキュリティ・サービスのために特別に作られた。	
item_Desc_cds_legacy_armor_heavy_core_01_9tails_01	アイテムタイプヘビーアーマー\nダメージ軽減40%\nキャリー容量：10.5k�SCU\n温度定格温度：-75 / 105\nバックパックとの互換性すべて\n\nCDSのADPコアを改良したバージョン。ADPヘビーアーマーシステムは、発売当初は画期的な防具として注目を集めました。クラーク・ディフェンス・システムズのマキシマリスト・デザインは、豊富なアタッチメント・ポイントを備え、風雨や敵の攻撃から身を守る。CDSは長年にわたってADPラインを改良し、形を変えてきたが、多くの人はまだオリジナルのADPを軍用重装甲の試金石と考えている。	
item_Desc_cds_legacy_armor_heavy_core_01_crus01_01	アイテムタイプヘビーアーマー\nダメージ軽減40%\nキャリー容量：10.5k�SCU\n温度定格温度：-75 / 105\nバックパックとの互換性すべて\n\n画期的なADPヘビーアーマーシステムは、発売当初、個人用プロテクションの最高峰と謳われました。クラーク・ディフェンス・システムズの最大主義的なデザインは、多くの取り付けポイントを提供し、要素や敵の砲火に対する優れた保護を提供します。CDSは長年にわたってADPラインを改良し、形を変えてきたが、多くの人はいまだにオリジナルのADPをミリタリーグレードのヘビーアーマーの試金石と考えている。クルセイダー・エディションは、同社のセキュリティ・サービスのために特別に作られた。	
item_Desc_cds_legacy_armor_heavy_helmet_01_crus01_01	アイテムタイプヘビーアーマー\nダメージ軽減40%\n温度レーティング: -75 / 105 �C\n\nクラーク・ディフェンス・システムズ社によって設計されたバロールは、すべてのパーツがダメージをより均等に分散するように設計されている。これにより、衝撃の力が重いヘルメット全体に分散され、他のヘルメットが故障しても持ちこたえることができる。クルセイダー・エディションは、同社のセキュリティサービス用に特別に作られた。	
item_Desc_cds_legacy_armor_heavy_legs_01_crus01_01	アイテムタイプヘビーアーマー\nダメージ軽減40%\nキャリー容量：6.5k�SCU\n温度定格温度: -75 / 105 °C\n\nADPヘビーアーマーシステムは、発売当初は画期的な防具として注目を集めました。クラーク・ディフェンス・システムズの最大主義的デザインは、豊富な装着ポイントを備え、風雨や敵の攻撃から身を守る。CDSは長年にわたってADPラインを改良し、形を変えてきたが、多くの人はいまだにオリジナルのADPをミリタリーグレードのヘビーアーマーの試金石と考えている。クルセイダー・エディションは、同社のセキュリティ・サービスのために特別に作られた。	
item_Desc_cds_legacy_armor_light_arms_01_crus01_01	アイテムタイプライトアーマー\nダメージ軽減率: 20%\n温度レーティング: -37 / 67 �C\n\nクラーク・ディフェンス・システムズが開発したPAB-1は、軽量でありながら十分な強度を備えている。独自のナノウィーブを採用した初のCDSスーツであるこのライトアーマーは、機敏な動きを維持しながらも若干のプロテクションを必要とする人々に愛用されるようになった。クルセイダー・エディションは、同社のセキュリティ・サービスのために特別に作られた。	
item_Desc_cds_legacy_armor_light_core_01_crus01_01	アイテムタイプライトアーマー\nダメージ軽減率：20\n携帯能力：4K�SCU\n温度耐温度：-40 / 70\nバックパック互換性ライト\n\nクラーク・ディフェンス・システムズが開発したPAB-1は、軽量ながら十分な強度を備えている。独自のナノウィーブを採用した最初のCDSスーツであるこのライトアーマーは、機敏な動きと同時に優れたプロテクションを必要とする人々に愛用されるようになった。クルセイダー・エディションは、同社のセキュリティ・サービスのために特別に作られた。	
item_Desc_cds_legacy_armor_light_helmet_01_crus01_01	アイテムタイプライトアーマー\nダメージ軽減率: 20%\n温度レーティング: -40 / 70 �C\n\nCBH-3は軽量合金を使用し、かなりのダメージにも耐えられるよう設計されたコンバットヘルメット。クルセイダー・エディションは、会社のセキュリティ・サービスのために特別に作られた。	
item_Desc_cds_legacy_armor_light_legs_01_01_9tails01	アイテムタイプライトアーマー\nダメージ軽減率：20\nキャリー容量：2.5K �SCU\n温度定格温度：-40 / 70\n\nCDSのPAB-1レッグに改良を加えたバージョン。クラーク・ディフェンス・システムズが開発したPAB-1は、軽量でありながら十分な強度を備えている。CDSが独自に開発したナノウィーブを採用した最初のスーツであるこのライトアーマーは、機敏な動きと同時にプロテクションを必要とする人々に愛用された。	
item_Desc_cds_legacy_armor_light_legs_01_crus01_01	アイテムタイプライトアーマー\nダメージ軽減率：20\nキャリー容量：2.5K �SCU\n温度定格温度：-40 / 70\n\nクラーク・ディフェンス・システムズが開発したPAB-1は、軽量でありながら十分な強度を持つ。独自開発のナノウィーブを採用したCDS初のライトアーマーは、機敏な動きと同時に高いプロテクションを必要とする人々に愛用された。クルセイダー・エディションは、同社のセキュリティ・サービスのために特別に作られた。	
item_Desc_cds_legacy_armor_medium_arms_01_crus01_01	アイテムタイプミディアム・アーマー\nダメージ軽減30%\n温度レーティング: -55 / 85 �C\n\n信頼性と耐久性に優れたアーマーは、流行に左右されることはない。クラーク・ディフェンス・システムズのORC-mkVは、何世紀にもわたって戦場の定番でした。複合メッキと特殊な繊維強化ポリマーを融合させることで、強固なプロテクションと広い可動域を実現し、高い評価を得ているミディアムアーマーです。クルセイダー・エディションは、同社のセキュリティ・サービスのために特別に作られた。	
item_Desc_cds_legacy_armor_medium_core_01_01_9tails01	アイテムタイプミディアム・アーマー\nダメージ軽減30%\nキャリー容量：7.5k�SCU\n温度定格温度：-55 / 85\nバックパックとの互換性ライト	
item_Desc_cds_legacy_armor_medium_core_01_crus01_01	アイテムタイプミディアム・アーマー\nダメージ軽減30%\nキャリー容量：7.5k�SCU\n温度定格温度：-55 / 85\nバックパックとの互換性ライト	
item_Desc_cds_legacy_armor_medium_helmet_01_crus01_01	アイテムタイプミディアム・アーマー\nダメージ軽減30%\n温度レーティング: -55 / 85 �C\n\nG-2は、かさばることなく保護と視界を確保します。クラーク・ディフェンス・システムズは、ヘルメットの完全性を損なうことなく、様々な衝撃に耐えられるように設計しました。クルセイダーエディションは、同社のセキュリティサービス用に特別に作られた。	
item_Desc_cds_legacy_armor_medium_legs_01_01_9tails01	アイテムタイプミディアム・アーマー\nダメージ軽減30%\nキャリー容量：4.5K�SCU\n温度定格温度：-55 / 85\n\nCDSのORC-mkVの脚部を改良したバージョン。信頼性と耐久性に優れたアーマーは流行に左右されない。クラーク・ディフェンス・システムズのORC-mkVは、何世紀にもわたって戦場の定番となっている。この高い評価を得ている中装甲は、複合メッキと特殊繊維強化ポリマーをブレンドすることで、強固な保護と広い可動域を実現している。	
item_Desc_cds_legacy_armor_medium_legs_01_crus01_01	アイテムタイプミディアム・アーマー\nダメージ軽減30%\nキャリー容量：4.5K�SCU\n温度定格温度：-55 / 85\n\nクラーク・ディフェンス・システムズのORC-MkVは、何世紀にもわたって戦場の定番として愛用されてきた。クラーク・ディフェンス・システムズのORC-mkVは、何世紀にもわたって戦場の定番となっています。複合メッキと特殊な繊維強化ポリマーを融合させることで、強固なプロテクションと広い可動域を実現し、高い評価を得ているミディアムアーマーです。クルセイダー・エディションは、同社のセキュリティ・サービスのために特別に作られた。	
item_Desc_cds_legacy_heavy_armor_01	アイテムタイプヘビーアーマー\nダメージ軽減40%\n温度レーティング: -75 / 105 �C\n\nADPヘビーアーマーシステムは、発売当初は画期的な防具として注目を集めました。クラーク・ディフェンス・システムズの最大主義的なデザインは、多くの取り付けポイントを提供し、要素や敵の砲火に対する優れた保護を提供します。CDSは長年にわたってADPラインを改良し、形を変えてきたが、多くの人はいまだにオリジナルのADPを軍用重装甲の試金石と考えている。	
item_Desc_cds_legacy_heavy_armor_01_core	アイテムタイプヘビーアーマー\nダメージ軽減40%\nキャリー容量：10.5k�SCU\n温度定格温度：-75 / 105\nバックパックとの互換性すべて\n\n画期的なADPヘビーアーマーシステムは、発売当初、個人用プロテクションの最高峰と謳われました。クラーク・ディフェンス・システムズの最大主義的なデザインは、多くの取り付けポイントを提供し、要素や敵の砲火に対する優れた保護を提供します。CDSは長年にわたってADPラインを改良し、形を変えてきたが、多くの人はいまだにオリジナルのADPを軍用重装甲の試金石と考えている。	
item_Desc_cds_legacy_heavy_armor_01_helmet	アイテムタイプヘビーアーマー\nダメージ軽減40%\n温度レーティング: -75 / 105 �C\n\nクラーク・ディフェンス・システムズ社によって設計されたバロールは、すべてのパーツがダメージをより均等に分散するように設計されている。これにより、衝撃がヘルメット全体に分散され、他のヘルメットでは耐えられないような衝撃にも耐えることができる。	
item_Desc_cds_legacy_heavy_armor_01_legs	アイテムタイプヘビーアーマー\nダメージ軽減40%\nキャリー容量：6.5k�SCU\n温度定格温度: -75 / 105 °C\n\nADPヘビーアーマーシステムは、発売当初は画期的な防具として注目を集めました。クラーク・ディフェンス・システムズの最大主義的デザインは、豊富な装着ポイントを備え、風雨や敵の攻撃から身を守る。CDSは長年にわたってADPラインを改良し、形を変えてきたが、多くの人はいまだにオリジナルのADPを軍用重装甲の試金石と考えている。	
item_Desc_cds_legacy_light_armor_01_arms	アイテムタイプライトアーマー\nダメージ軽減率: 20%\n温度レーティング: -37 / 67 �C\n\nクラーク・ディフェンス・システムズが開発したPAB-1は、軽量でありながら十分な強度を備えている。独自のナノウィーブを採用した最初のCDSスーツであるこのライトアーマーは、機敏な動きと同時にプロテクションを必要とする人々に愛用された。	
item_Desc_cds_legacy_light_armor_01_core	アイテムタイプライトアーマー\nダメージ軽減率：20\n携帯能力：4K�SCU\n温度耐温度：-40 / 70\nバックパック互換性ライト\n\nクラーク・ディフェンス・システムズが開発したPAB-1は、軽量ながら十分な強度を備えている。独自のナノウィーブを採用した最初のCDSスーツであるこのライトアーマーは、機敏な動きと同時にプロテクションを必要とする人々に愛用されるようになった。	
item_Desc_cds_legacy_light_armor_01_helmet	アイテムタイプライトアーマー\nダメージ軽減率: 20%\n温度レーティング: -40 / 70 �C\n\nCBH-3は軽量合金を使用し、かなりのダメージにも耐えられるよう設計されたコンバットヘルメットです。	
item_Desc_cds_legacy_light_armor_01_legs	アイテムタイプライトアーマー\nダメージ軽減率：20\nキャリー容量：2.5K �SCU\n温度定格温度：-40 / 70\n\nクラーク・ディフェンス・システムズが開発したPAB-1は、軽量でありながら十分な強度を持つ。独自のナノウィーブを採用した最初のCDSスーツであるこのライトアーマーは、機敏な動きと同時にプロテクションを必要とする人々に愛用されるようになった。	
item_Desc_cds_legacy_medium_armor_01	アイテムタイプミディアム・アーマー\nダメージ軽減30%\n温度レーティング: -55 / 85 �C\n\n信頼性と耐久性に優れたアーマーは、流行に左右されることはない。クラーク・ディフェンス・システムズのORC-mkVは、何世紀にもわたって戦場の定番でした。この高い評価を得ている中型アーマーは、複合メッキと特殊繊維強化ポリマーをブレンドすることで、強固な保護と広い可動域を実現しています。	
item_Desc_cds_legacy_medium_armor_01_core	アイテムタイプミディアム・アーマー\nダメージ軽減30%\nキャリー容量：7.5k�SCU\n温度定格温度：-55 / 85\nバックパックとの互換性ライト	
item_Desc_cds_legacy_medium_armor_01_helmet	アイテムタイプミディアム・アーマー\nダメージ軽減30%\n温度レーティング: -55 / 85 �C\n\nG-2は、かさばることなく保護と視界を確保します。クラーク・ディフェンス・システムズは、ヘルメットの完全性を損なうことなく、様々な衝撃に耐えられるように設計されています。	
item_Desc_cds_legacy_medium_armor_01_legs	アイテムタイプミディアム・アーマー\nダメージ軽減30%\nキャリー容量：4.5K�SCU\n温度定格温度：-55 / 85\n\nクラーク・ディフェンス・システムズのORC-MkVは、何世紀にもわたって戦場の定番として愛用されてきた。クラーク・ディフェンス・システムズのORC-mkVは、何世紀にもわたって戦場の定番となっています。この高い評価を得ている中型アーマーは、複合メッキと特殊繊維強化ポリマーをブレンドすることで、強固な保護と広い可動域を実現しています。	
item_Desc_cds_light_armor_01_Shared	アイテムタイプライトアーマー\nダメージ軽減率: 20%\n温度レーティング: -35 / 65 �C\n\nCDS�フィールド・リコン・スーツは、状況に応じた機敏さを損なうことなく、少しでも高いプロテクションを求めるコンバット・オペレーターに最適なソリューションです。EdgeCoreコンポジットメッキがナノウィーブスーツに戦略的に縫い込まれ、スーツの柔軟性を保ちながら重要な器官をカバーします。	
item_Desc_cds_light_armor_01_core	アイテムタイプライトアーマー\nダメージ軽減率：20\n携帯能力：4K�SCU\n温度定格温度：-32 / 62\nバックパック互換性ライト\n\nCDS�フィールド・リコン・スーツは、状況に応じた機敏さを損なうことなく、少しでも高いプロテクションを求めるコンバット・オペレーターに最適なソリューションです。エッジコア複合メッキがナノ織りスーツに戦略的に縫い込まれ、スーツの柔軟性を保ちながら重要な器官をカバーします。	
item_Desc_cds_light_armor_01_legs	アイテムタイプライトアーマー\nダメージ軽減率：20\nキャリー容量：2.5K �SCU\n温度定格温度：-35 / 65\n\nCDS�フィールド・リコン・スーツは、状況に応じて機敏さを損なうことなく、少しでも高いプロテクションを求めるコンバット・オペレーターに最適なソリューションです。エッジコア複合メッキは、スーツの柔軟性を維持しながら、重要な器官をカバーするためにナノ織りスーツに戦略的に縫い込まれています。	
item_Desc_cds_medium_armor_01_Shared	アイテムタイプミディアム・アーマー\nダメージ軽減30%\n温度レート: -61 / 91 �C\n\nマークXはCDS�の受賞歴のあるオムニロールコンバットアーマーシリーズの最新作です。このEVA規格のスーツは、新しいEdgeCoreコンポジットウィーブテクノロジーを採用し、オペレーターの敏捷性を最小限に抑えながら、投射物、爆発物、要素からの保護を最大化します。	
item_Desc_cds_medium_armor_01_core	アイテムタイプミディアム・アーマー\nダメージ軽減30%\nキャリー容量：7.5k�SCU\n温度定格温度：-61 / 91\nバックパックとの互換性ライト	
item_Desc_cds_medium_armor_01_legs	アイテムタイプミディアム・アーマー\nダメージ軽減30%\nキャリー容量：4.5K �SCU\n温度定格温度：-61 / 91\n\nマークXは、CDS�の受賞歴のあるオムニロールコンバットアーマーシリーズの最新作です。このEVA規格のスーツは、新しいEdgeCoreコンポジットウィーブテクノロジーを採用し、オペレーターの敏捷性を最小限に抑えながら、投射物、爆発物、要素から最大限に防護します。	
item_Desc_cds_medium_armor_02_Shared	アイテムタイプミディアム・アーマー\nダメージ軽減30%\nキャリー容量：7.5k�SCU\n温度定格温度：-61 / 91\n\nマークXは、CDS�の受賞歴のあるオムニロールコンバットアーマーシリーズの最新作です。このEVA規格のスーツは、オペレーターの敏捷性を妨げることなく、投射物や爆発物、外的要因から最大限に防護する新しいエッジコア複合織物技術を採用しています。	
item_Desc_cds_medium_armor_02_helmet	アイテムタイプミディアム・アーマー\nダメージ軽減30%\n温度レーティング: -63 / 93 �C\n\nマークXはCDS�の受賞歴のあるオムニロールコンバットアーマーシリーズの最新作です。このEVA規格のスーツは、オペレーターの敏捷性を妨げることなく、投射物や爆発物、外的要因から最大限に防護する新しいEdgeCoreコンポジットウィーブテクノロジーを特徴としています。	
item_Desc_cds_medium_armor_02_legs	アイテムタイプミディアム・アーマー\nダメージ軽減30%\nキャリー容量：4.5K �SCU\n温度定格温度：-61 / 91\n\nマークXは、CDS�の受賞歴のあるオムニロールコンバットアーマーシリーズの最新作です。このEVA規格のスーツは、新しいEdgeCoreコンポジットウィーブテクノロジーを採用し、オペレーターの敏捷性を最小限に抑えながら、投射物、爆発物、要素から最大限に防護します。	
item_Desc_cds_undersuit_01_crus01_01	アイテムタイプアンダースーツ\nダメージ軽減10%\n温度レーティング: -30 / 60 �C\n\nこの包括的なタクティカル・コンバット・スーツは、真空に対する完全な密閉型スーツを提供し、自由な可動域を確保し、互換性のあるアーマー・システムとのシームレスなインターフェイスを提供します。クルセイダー・エディションは、会社のセキュリティ・サービスのために特別に作られた。	
item_Desc_cds_undersuit_helmet_01	アイテムタイプライトアーマー\nダメージ軽減率: 20%\n温度レーティング: -30 / 60 �C\n\nA23は長年CDSの主力ヘルメットシステムの一つです。A23は、耐衝撃性に優れたコンポジット・テクノロジーと硬化ラミネート・フェースプレートで作られており、危険な環境や基本的なEVA作業に最適です。	
item_Desc_clda_env_armor_backpack_01	アイテムタイプヘビーバックパック\nキャリー容量： 120K �SCU\nコア適合性：ヘビー\n\nノビコフを着用すれば、寒冷な環境でも自信を持って探検できます。カルデラはこの先進的な探検スーツを補完するために広々としたバックパックを設計し、未知の地形を冒険する人が旅を乗り切るのに十分な物資を持ち運べるようにしました。	
item_Desc_clda_env_armor_backpack_01_expo	アイテムタイプヘビーバックパック\nキャリー容量： 120K �SCU\nコア適合性：ヘビー\n\nノビコフ "エキスポ "を着用し、寒冷地を自信を持って探検しましょう。カルデラはこの先進的な探検スーツを補完するために広々としたバックパックを設計し、未知の地形を冒険する人が旅を乗り切るのに十分な物資を持ち運べるようにしました。	
item_Desc_clda_env_armor_heavy_suit_01_01_9tails01	アイテムタイプヘビーアーマー\nダメージ軽減40%\nキャリー容量：22k�SCU\n温度定格温度: -225 / 75 °C\n\nカルデラのノビコフ探検スーツを改良したバージョン。ノビコフを着用することで、寒冷な環境でも自信を持って探索することができます。カルデラが開発したこのアーマーは、環境条件に合わせてインテリジェントに調整する先進的なセンサーを搭載し、着用者の体温を安定させます。また、最先端の生命維持システムと広々としたバックパックを備え、未知の地形を横断する冒険者は、ノビコフを頼りに旅を乗り切ることができる。	
item_Desc_clda_env_heat_armor_backpack_01	アイテムタイプヘビーバックパック\n耐荷重： 120K �SCU\n温度定格： -75 / 225 �C\n\nペムブロークは人間の耐久力の限界を超えるために設計され、人を寄せ付けない高温環境の極限の暑さに耐えられるように作られています。カルデラのクラス最高の探査用アーマープラットフォームをベースに、高度なセンサー群が環境条件にインテリジェントに適応し、着用者の体温を安定させます。また、最先端の生命維持装置と広々としたキャリーケースを備え、新たな地平を大胆に横断しようとする人々は、ペンブロークに旅の終わりまで頼ることができる。	
item_Desc_clda_env_heat_heavy_helmet_01	アイテムタイプヘビーアーマー\nダメージ軽減40%\n温度レーティング: -75 / 225 �C\n\n人間の耐久力の限界を広げるために設計されたペンブロークは、人を寄せ付けない高温環境の酷暑に耐えるように作られている。カルデラのクラス最高の探査用アーマープラットフォームをベースに、高度なセンサー群が環境条件にインテリジェントに適応し、着用者の体温を安定させます。また、最先端の生命維持装置と広々としたキャリーケースを備え、新たな地平を大胆に横断しようとする人々は、ペンブロークに旅の終わりまで頼ることができる。	
item_Desc_clda_env_heat_heavy_suit_01	アイテムタイプヘビーアーマー\nダメージ軽減40%\nキャリー容量：22k�SCU\n温度定格温度: -75 / 225 °C\n\nペムブロークは人間の耐久力の限界を広げるために設計され、人を寄せ付けない高温環境の極限の暑さに耐えられるように作られています。カルデラのクラス最高の探査用アーマープラットフォームをベースに、高度なセンサー群が環境条件にインテリジェントに適応し、着用者の体温を安定させます。また、最先端の生命維持装置と広々としたキャリーケースを備え、新たな地平を大胆に横断しようとする人々は、ペンブロークに旅の終わりまで頼ることができる。	
item_Desc_clda_env_heavy_arms_01	アイテムタイプヘビーアーマー\nダメージ軽減40%\n温度レーティング: -225 / 75 �C\n\nノビコフを着用すれば、寒い環境でも自信を持って探索できる。カルデラが開発したエクスプロレーション・スーツは、環境条件にインテリジェントに適応し、着用者の体温を安定させます。また、最先端のライフサポートシステムと広々としたバックパックを装備し、未知の地形に挑む人は、Novikovを頼りに旅を乗り切ることができる。	
item_Desc_clda_env_heavy_arms_01_expo	アイテムタイプヘビーアーマー\nダメージ軽減40%\n温度レーティング: -225 / 75 �C\n\nノビコフ "エキスポ "を着用すれば、寒冷な環境でも自信を持って探索できる。カルデラが開発したエクスプロレーション・スーツは、環境条件にインテリジェントに適応し、着用者の体温を安定させます。また、最先端の生命維持システムと広々としたキャリーケースを備え、未知の地形を横断する冒険者は、旅を生き延びるためにノビコフを頼りにすることができる。シチズン・コン2949を記念した "エキスポ "エディションは、オレンジとパープルをブレンドし、風雨の中でも視認性の高い、目を引くデザインに仕上がっている。	
item_Desc_clda_env_heavy_core_01	アイテムタイプヘビーアーマー\nダメージ軽減40%\n運搬能力：?\n温度定格温度: -225 / 75 °C\n\nノビコフを着用すれば、寒冷な環境でも自信を持って探索できます。カルデラが開発したエクスプロレーション・スーツは、環境条件にインテリジェントに適応し、着用者の体温を安定させます。また、最先端のライフサポートシステムと広々としたバックパックを装備し、未知の地形に挑む人は、Novikovを頼りに旅を乗り切ることができる。	
item_Desc_clda_env_heavy_core_01_expo	アイテムタイプヘビーアーマー\nダメージ軽減40%\n運搬能力：?\n温度定格温度: -225 / 75 °C\n��\nノビコフ "エキスポ "を着用して、寒冷な環境を自信を持って探検してください。カルデラが開発したこの探検スーツは、環境条件に合わせてインテリジェントに調整し、着用者の体温を安定させます。シチズン・コン2949を記念した "Expo "エディションは、オレンジとパープルが混ざり合い、目を引くデザインとなっている。	
item_Desc_clda_env_heavy_helmet_01	アイテムタイプヘビーアーマー\nダメージ軽減40%\n温度レーティング: -225 / 75 �C\n\nノビコフを着用すれば、寒い環境でも自信を持って探索できる。カルデラが開発したエクスプロレーション・スーツは、環境条件に合わせてインテリジェントに調整し、着用者の体温を安定させます。また、最先端のライフ・サポート・システムと一体化した特注のヘルメットも特徴で、未知の地形を横断する冒険者は、Novikovを頼りに旅を乗り切ることができる。	
item_Desc_clda_env_heavy_helmet_01_expo	アイテムタイプヘビーアーマー\nダメージ軽減40%\n温度レーティング: -225 / 75 �C\n\nノビコフ "エキスポ "を着用すれば、寒冷な環境でも自信を持って探索できる。カルデラが開発したエクスプロレーション・スーツは、環境条件にインテリジェントに適応し、着用者の体温を安定させる高度なセンサー群を備えている。また、最先端の生命維持システムと統合された特注のヘルメットも装備しており、未知の地形を横断する冒険者は、ノビコフを頼りに旅を生き延びることができる。�「エキスポ」エディションは、シチズン・コン2949を記念して、オレンジとパープルをブレンドし、風雨の中でも視認性の高い、目を引く外観に仕上げている。	
item_Desc_clda_env_heavy_legs_01	アイテムタイプヘビーアーマー\nダメージ軽減40%\n運搬能力：?\n温度定格温度: -225 / 75 °C\n\nノビコフを着用すれば、寒冷な環境でも自信を持って探索できます。カルデラが開発したエクスプロレーション・スーツは、環境条件にインテリジェントに適応し、着用者の体温を安定させます。また、最先端のライフサポートシステムと広々としたバックパックを装備し、未知の地形に挑む人は、Novikovを頼りに旅を乗り切ることができる。	
item_Desc_clda_env_heavy_legs_01_expo	アイテムタイプヘビーアーマー\nダメージ軽減40%\n運搬能力：?\n温度定格温度: -225 / 75 °C\n\nノビコフ "エキスポ "を着用して、自信を持って寒冷環境を探検してください。カルデラが開発したエクスプロレーション・スーツは、環境条件にインテリジェントに適応し、着用者の体温を安定させます。また、最先端の生命維持システムと広々としたキャリーケースを備え、未知の地形を横断する冒険者は、旅を生き延びるためにノビコフを頼りにすることができる。シチズン・コン2949を記念した "エキスポ "エディションは、オレンジとパープルをブレンドし、風雨の中でも視認性の高い、目を引くデザインに仕上がっている。	
item_Desc_clda_env_heavy_suit_01	アイテムタイプヘビーアーマー\nダメージ軽減40%\nキャリー容量：22k�SCU\n温度定格温度: -225 / 75 °C\n\nノビコフを着用すれば、寒冷な環境でも自信を持って探索できます。カルデラが開発したこの探検スーツは、環境条件に合わせてインテリジェントに調整する先進的なセンサーを搭載し、着用者の体温を安定させます。また、最先端のライフサポートシステムと広々としたバックパックを装備し、未知の地形に挑む人は、Novikovを頼りに旅を乗り切ることができる。	
item_Desc_clda_env_heavy_suit_01_expo	アイテムタイプヘビーアーマー\nダメージ軽減40%\nキャリー容量：22k�SCU\n温度定格温度: -225 / 75?\n\nノビコフ "エキスポ "を着用すれば、寒冷な環境でも自信を持って探検できます。カルデラが開発したエクスプロレーション・スーツは、環境条件にインテリジェントに適応し、着用者の体温を安定させます。また、最先端の生命維持システムと広々としたキャリーケースを備え、未知の地形を横断する冒険者は、旅を生き延びるためにノビコフを頼りにすることができる。シチズン・コン2949を記念した "エキスポ "エディションは、オレンジとパープルをブレンドし、風雨の中でも視認性の高い、目を引くデザインに仕上がっている。	
item_Desc_clda_gloves_01	バダミ・グローブの裏地には先進の耐切創バリアが施され、3層構造の内装と相まって、カルデラならではの高度な衝撃保護システムを作り出している。	
item_Desc_clda_helmet_01	カルデラのBadamiヘルメットは、強靭なポリカーボネート製シェルと抗菌ライナーで頭部を保護し、どんな未開の地にも果敢に挑むことができる。このヘルメットは宇宙用ではないので、通気性の良い環境でのみ着用してください。	
item_Desc_clda_undersuit_01_01_01	アイテムタイプアンダースーツ\nダメージ軽減10%\n温度レーティング: -30 / 60 �C\n\nより快適で自然な動きを可能にするフレキシブルなガスケットと、便利な胸部コネクターポートオプションを備えたカルデラのレヴィンは、あらゆる探検家にとって実用的な選択肢となっている。このアンダースーツは、長時間の使用に耐えるよう修理済みです。	
item_Desc_clda_utility_heavy_backpack_01	アイテムタイプヘビーバックパック\nキャリー容量： 120K �SCU\nコア適合性：ヘビー\n\nペムブロークは人間の耐久力の限界を広げるために設計され、人を寄せ付けない高温環境の極限の暑さに耐えられるように作られています。カルデラのクラス最高の探査用アーマープラットフォームをベースに、高度なセンサー群が環境条件に合わせてインテリジェントに調整し、着用者の体温を安定させます。広々としたバックパックがこの先進的なアーマーを引き立て、大胆な新しい地平線を越えようとする人たちは、旅の終わりまでペンブロークに頼ることができる。	
item_Desc_clda_utility_heavy_backpack_02	アイテムタイプヘビーバックパック\nキャリー容量： 120K �SCU\nコア適合性：ヘビー\n\nペムブロークRSIエディションは、人間の耐久性の限界を広げるために設計され、人を寄せ付けない高温環境の極限の暑さに耐えられるように作られています。カルデラのクラス最高の探査用アーマープラットフォームをベースに、高度なセンサー群が環境条件に合わせてインテリジェントに調整し、着用者の体温を安定させます。広々としたバックパックが特徴的なペンブロークのRSIエディションは、大胆な新しい地平線を越えようとする人たちをスタイリッシュにサポートします。	
item_Desc_clda_utility_heavy_backpack_02_01_9tails01	アイテムタイプヘビーバックパック\nキャリー容量： 120K �SCU\nコア適合性：ヘビー\n\nカルデラのペンブローク・バックパックを改良したバージョン。ペムブロークRSIエディションは、人間の耐久性の限界を広げるために設計され、人を寄せ付けない高温環境の極限の暑さに耐えられるように作られています。カルデラのクラス最高の探査用アーマープラットフォームをベースに、高度なセンサー群が環境条件に合わせてインテリジェントに調整し、着用者の体温を安定させます。広々としたバックパックが特徴的なペンブロークのRSIエディションは、大胆な新しい地平線を越えようとする人たちをスタイリッシュにサポートします。	
item_Desc_clda_utility_heavy_helmet_01	アイテムタイプヘビーアーマー\nダメージ軽減40%\n温度レーティング: -75 / 225 �C\n\n人間の耐久力の限界を広げるために設計されたペンブロークは、人を寄せ付けない高温環境の酷暑に耐えるように作られている。カルデラのクラス最高の探査用アーマープラットフォームをベースに、高度なセンサー群が環境条件に合わせてインテリジェントに調整し、着用者の体温を安定させます。また、最先端の生命維持システムと統合された特注のヘルメットも特徴で、大胆な新しい地平線を越えようとする人たちは、旅の終わりまでペンブロークに頼ることができる。	
item_Desc_clda_utility_heavy_helmet_02	アイテムタイプヘビーアーマー\nダメージ軽減40%\n温度レーティング: -75 / 225 �C\n\nペムブロークRSIエディションは、人間の耐久力の限界を超えるために設計され、人を寄せ付けない高温環境の極限の暑さに耐えられるように作られています。カルデラのクラス最高の探査用アーマープラットフォームをベースに、高度なセンサー群が環境条件に合わせてインテリジェントに調整し、着用者の体温を安定させます。また、最先端の生命維持システムと統合された特注のヘルメットも特徴で、ペンブロークのRSIエディションは、大胆な新しい地平線を渡ろうとする人たちがスタイリッシュに渡れることを保証します。	
item_Desc_clda_utility_heavy_helmet_02_01_9tails01	アイテムタイプヘビーアーマー\nダメージ軽減40%\n温度レーティング: -75 / 225 �C\n\nカルデラのペンブローク・ヘルメットの原型を改良したバージョン。ペムブロークRSIエディションは、人間の耐久性の限界を広げるために設計され、人を寄せ付けない高温環境の極限の暑さに耐えられるように作られています。カルデラのクラス最高の探査用アーマープラットフォームをベースに、高度なセンサー群が環境条件に合わせてインテリジェントに調整し、着用者の体温を安定させます。また、最先端の生命維持システムと統合された特注のヘルメットも特徴で、ペンブロークのRSIエディションは、大胆な新しい地平線を渡ろうとする人たちがスタイリッシュに渡れることを保証します。	
item_Desc_clda_utility_heavy_suit_01	アイテムタイプヘビーアーマー\nダメージ軽減40%\n温度レーティング: -75 / 225 �C\nバックパックとの互換性すべて\n\nペムブロークは人間の耐久性の限界を広げるために設計され、人を寄せ付けない高温環境の極限の暑さに耐えられるように作られています。カルデラのクラス最高の探査用アーマープラットフォームをベースに、高度なセンサー群が環境条件に合わせてインテリジェントに調整し、着用者の体温を安定させます。また、最先端のライフ・サポート・システムも搭載しており、新たな地平を大胆に横断しようとする人々は、ペンブロークに旅の終わりまで頼ることができる。	
item_Desc_clda_utility_heavy_suit_02	アイテムタイプヘビーアーマー\nダメージ軽減40%\n温度レーティング: -75 / 225 �C\nバックパックとの互換性すべて\n\nペムブロークは人間の耐久性の限界を広げるために設計され、人を寄せ付けない高温環境の極限の暑さに耐えられるように作られています。カルデラのクラス最高の探査用アーマープラットフォームをベースに、高度なセンサー群が環境条件に合わせてインテリジェントに調整し、着用者の体温を安定させます。ペンブロークの特別なRSIエディションは、大胆な新しい地平線を越えようとする人たちが、スタイリッシュにそうすることを保証します。	
item_Desc_clda_utility_heavy_suit_02_01_9tails01	アイテムタイプヘビーアーマー\nダメージ軽減40%\n温度レーティング: -75 / 225 �C\nバックパックとの互換性すべて\n\nカルデラのペムブローク・エクスプロレーション・スーツに改良を加えたバージョン。ペムブロークは人間の耐久力の限界を広げるために設計され、人を寄せ付けない高温環境の極端な暑さにも耐えられるように作られています。カルデラのクラス最高の探査用アーマープラットフォームをベースに、高度なセンサー群が環境条件に合わせてインテリジェントに調整し、着用者の体温を安定させます。ペンブロークの特別なRSIエディションは、大胆な新しい地平線を越えようとする人たちが、スタイリッシュにそうすることを保証します。	
item_Desc_ctl_deckcrew_undersuit_01_lum01_01	アイテムタイプアンダースーツ\nダメージ軽減10%\n温度レーティング: -5 / 50 �C\n\n耐久性に優れたポリファイバー素材、快適なフィット感、ホリデーシーズンならではのデザインが特徴のアンダースーツ。	
item_Desc_ctl_deckcrew_undersuit_01_lum01_06	アイテムタイプアンダースーツ\nダメージ軽減10%\n温度レーティング: -5 / 50 �C\n\n耐久性に優れたポリファイバー素材、快適なフィット感、ホリデーシーズンならではのデザインが特徴のアンダースーツ。	
item_Desc_ctl_deckcrew_undersuit_01_lum01_07	アイテムタイプアンダースーツ\nダメージ軽減10%\n温度レーティング: -5 / 50 �C\n\n耐久性に優れたポリファイバー素材、快適なフィット感、ホリデーシーズンならではのデザインが特徴のアンダースーツ。	
item_Desc_dmc_frontier_jacket_01_01_01	キャリング容量：1K µSCU\n\nフロンティアでは、厳しい状況でもほつれない信頼性の高い衣服が必要です。DMCがシルバートン・ジャケットを作ったのはそのためで、エレメントに強いレザーをダブルステッチで使用し、物資を手元に置いておけるよう、ゆとりのあるポケットをたくさん備えています。Silvertonがあれば、どんなことにも対応できる。	
item_Desc_dmc_frontier_pants_01_01_01	キャリング容量：1K µSCU\n\n丈夫で柔軟な素材をブレンドしたSilvertonパンツは、機動性を犠牲にすることなくヘビーデューティーなワークウェアを必要とする人に最適です。仕事がおありですか？お任せください。	
item_Desc_dmc_jacket_05	キャリング容量：1K µSCU\n\n耐水性に優れたギリーダウンを詰め込んだコロマコートは、風を遮り、体温を逃がさず、自由に動くことができるため、変わりやすい天候に最適です。また、広々としたポケットは収納力にも優れている。	
item_Desc_dmc_shirt_01	グリーンウォーターは、一般的なアーマーの下に着用できるように作られた長袖シャツ。天然繊維と合成繊維をミックスした丈夫な素材で作られており、着心地を犠牲にすることなく日々の消耗に耐える。	
item_Desc_doom_armor_medium_arms_02_01_01	アイテムタイプミディアム・アーマー\nダメージ軽減30%\n温度レーティング: -52 / 82 �C\n\nスクラップ・シックで印象的なドレス！Stitcherアーマーは、テープと善意で組み立てられているように見えるかもしれませんが、宇宙空間でも安全です。ファンキーな二重襟、豊富な収納、背中のメタルシリンダーに取り付けられた産業用ホースが特徴。	
item_Desc_doom_armor_medium_core_02_01_01	アイテムタイプミディアム・アーマー\nダメージ軽減30%\nキャリー容量：7.5k�SCU\n温度レーティング： -52 / 82 �C\nバックパックとの互換性ライト	
item_Desc_doom_armor_medium_legs_02_01_01	アイテムタイプミディアム・アーマー\nダメージ軽減30%\nキャリー容量：4.5k�SCU\n温度定格温度: -52 / 82 °C\n\nスクラップをシックに着こなす！Stitcherアーマーは、テープと善意で組み立てられているように見えるかもしれませんが、宇宙空間でも安全です。ファンキーな二重襟、豊富な収納、背中のメタルシリンダーに取り付けられた産業用ホースが特徴。	
item_Desc_doom_combat_medium_backpack_01	アイテムタイプミディアムバックパック\n容量： 70K �SCU\nコアの互換性ミディアム	
item_Desc_doom_medium_armor_01_Shared	アイテムタイプミディアム・アーマー\nダメージ軽減30%\n温度レーティング: -52 / 82 �C\n\n時には、自分のメッセージをはっきりと伝えるために適切なアーマーを身につける必要がある。クラッシュアーマーはドレッジがアーマーを大量生産するよう強硬手段に出た時に初めて出現し、それ以来皆を怖がらせている。今では誰もがそれを盗んでいる。クラッシュは強化されたミディアムプレートが特徴で、スピードを犠牲にすることなくバランスの取れたプロテクションを得ることができる。	
item_Desc_doom_medium_armor_01_core	アイテムタイプミディアム・アーマー\nダメージ軽減30%\nキャリー容量：7.5k�SCU\n温度レーティング： -52 / 82 �C\nバックパックとの互換性ライト	
item_Desc_doom_medium_armor_01_legs	アイテムタイプミディアム・アーマー\nダメージ軽減30%\nキャリー容量：4.5K �SCU\n温度定格温度: -52 / 82 °C\n\n時には、適切なアーマーを身につけることで、自分のメッセージをはっきりと伝えることができる。クラッシュアーマーは、ドレッジがアーマーを大量生産するよう強硬手段に出たときに初めて出現し、それ以来、みんなを怖がらせている。今では誰もがそれを盗んでいる。クラッシュは強化されたミディアムプレートが特徴で、スピードを犠牲にすることなくバランスの取れたプロテクションを得ることができる。	
item_Desc_doom_medium_armor_helmet_01	アイテムタイプミディアム・アーマー\nダメージ軽減30%\n温度レーティング: -52 / 82 �C\n\n高品質なスカベンジを使用し、成型されたフェースプレートで作られたデスズ・ヘッド。	
item_Desc_doom_medium_armor_helmet_02	アイテムタイプミディアム・アーマー\nダメージ軽減30%\n温度レーティング: -52 / 82 �C\n\n動物の形をした恐ろしいヘルメットで死神になろう。我々は獣医ではない。このヘルメットをかぶれば、ひどい仕打ちにも耐えられそうだ。	
item_Desc_doom_medium_armor_helmet_02_holiday	アイテムタイプミディアム・アーマー\nダメージ軽減30%\n温度レーティング: -52 / 82 �C\n\nホリデー・ブッチャー・ヘルメットで季節を祝おう。ドゥームズデイがデザインしたこのアーマーは、銃撃戦や騒がしいホリデーパーティーなど、あらゆる状況に耐えることができる。カスタムされたアーマーメッキの鼻は、軽量ながらプロテクションを提供し、合成のスパイラルホーンは本物よりも耐久性がある。ホリデー・ブッチャーは、宇宙一の歪んだギアのエンジニアとしてのドゥームズデイの名声をさらに高めている。	
item_Desc_grin_toxic_jumpsuit_01	TruBarrierハザード・スーツは、工業用ファブリックで構成され、多層ラミネート・ポリマーでコーティングされているため、機動性を犠牲にすることなく、幅広い化学的防護を提供します。カプセル化されたデザインは、付属のマスクと一緒に着用することで、危険物質との直接接触から全身を保護します。	
item_Desc_grin_toxic_mask_01	Greycat IndustrialのTruBarrierハザード・マスクは、頭の最も傷つきやすい部分を損傷から守りながら、予期せぬ環境の危険に直面するユーザーをサポートします。付属のジャンプスーツと一緒に着用することで、危険物との直接接触から全身を保護します。	
item_Desc_grin_utility_medium_helmet_01_01_9tails01	アイテムタイプミディアム・アーマー\nダメージ軽減30%\n温度レート: -61 / 91 �C\n \nグレイキャット・インダストリアルのアリル・ヘルメットをオリジナルから改良したバージョン。元々鉱夫用にデザインされたアリルのアーマーは、完全に密閉されたヘルメットと高い襟を持ち、首と後頭部をサポートし保護します。一体型のツールベルトと取り付け可能なバックパックには、さまざまなツールや消耗品を収納でき、両手が自由に使える。アリルアーマーは、好みに合わせて、また現場で識別しやすいように、鮮やかなカラーバリエーションが用意されている。	
item_Desc_grin_utility_medium_legs_01_01_9tails01	アイテムタイプミディアム・アーマー\nダメージ軽減30%\nキャリー容量：10K�SCU\n温度定格温度： -61 / 91\n \nグレイキャット・インダストリアルのアリル・レッグに改良を加えたバージョン。元々鉱夫用にデザインされたアリルのアーマーには、完全密閉型のヘルメットと高い襟があり、首と後頭部をサポートし保護します。一体化されたツールベルトと取り付け可能なバックパックには、さまざまなツールや消耗品を収納でき、両手が自由に使える。アリルアーマーは、好みに合わせて、また現場で識別しやすいように、鮮やかなカラーバリエーションが用意されている。	
item_Desc_gsb_boots_10	未開の地を歩くとき、汚れは仕事の一部でしかない。このデザート・キャット・ブーツは、熱や汗を逃がしながら汚れをはじく薄い膜でコーティングされている。	
item_Desc_gsb_shoes_05,P	PH - gsb_shoes_05	
item_Desc_hdh_boots_01	長持ちするように作られたハビダッシュのパラダンブーツは、シンプルで頑丈、そして信頼できる。ブーツの外側は厚手の合成素材でできており、水や砂、雪から着用者を守り、内側は柔軟性のあるフォームを使用しているため、何年も快適な履き心地を保つことができる。	
item_Desc_hdh_hat_04_01_04,P	PH - item_Desc_hdh_hat_04_01_04	
item_Desc_hdh_jacket_05_01_01	キャリング容量：1K µSCU\n\n風の剪断を軽減するようデザインされたアウターシェルと、快適性を損なうことなく保温性を保つインナーシェルを備えたトゥルシージャケット。使いやすさを考慮し、トップストップ付きのジェントル・グライド・ジッパーを採用し、必要なものが常に手元にあることを保証する広々としたポケットを備えています。	
item_Desc_hdh_pants_01_01_01	キャリング容量：1K µSCU\n\nZelenaパンツとBisbeeブーツで雨の日も暖かくドライに。撥水加工を施した素材と吸汗速乾テクノロジーを内蔵したこの2つのブーツは、過酷な世界でのアドベンチャーに最適です。	
item_Desc_hdtc_undersuit_01_01_01	アイテムタイプアンダースーツ\nダメージ軽減10%\n温度レーティング: -5 / 50 �C\n\nLamontは、アーマーの上にアーマーを着たくないと思わせるほど見た目が良い。軽量メッキと耐久性のある合成繊維をシームレスに融合させたLamontは、コックピットでも街中でもスタイリッシュで快適です。仕事にも遊びにも適したパーソナル・プロテクション・ギアで、ハーディン・タクティカルのアドバンテージを手に入れてください。	
item_Desc_hdtc_utility_light_backpack_01	アイテムタイプ軽量バックパック\n容量： 50K �SCU\nコアの互換性すべて\n\nキャタビーはハーディンタクティカルが開発した、過酷な冒険にも耐えるスタイリッシュなバックパックです。丈夫で伸縮性のあるソフトシェルをハードフレームで囲み、2つのジッパー付きポケットで必需品の出し入れが簡単です。MPUV-1Cエディションには、アルゴ・カーゴの2951ベスト・イン・ショー優勝を記念したパッチも付属しています。	
item_Desc_ksar_light_armor_01	アイテムタイプライトアーマー\nダメージ軽減率: 20%\n温度レーティング: -33 / 63 �C\n\nアーマースーツが手頃な価格で効果的だなんて、誰が想像できただろう。Kastak ArmsのMicroid Battle Suitは完璧な入門用アーマーセットである。セラミックプレートが重要な部分を保護し、マイクロウィーブがそれ以外の部分をカバーする。	
item_Desc_ksar_light_armor_core_01	アイテムタイプライトアーマー\nダメージ軽減率：20\n携帯能力：5K�SCU\n温度耐温度： -33 / 63\nバックパック互換性ライト\n\n手頃な価格で効果的なアーマースーツが手に入るとは誰が想像しただろうか。Kastak ArmsのMicroid Battle Suitは入門用として最適なアーマーセットです。セラミックプレートが重要な部分を保護し、マイクロウィーブがそれ以外の部分をカバーする。	
item_Desc_ksar_light_armor_legs_01	アイテムタイプライトアーマー\nダメージ軽減率：20\n携帯能力：3K�SCU\n温度定格温度：-33 / 63\n\n手頃な価格で効果的なアーマースーツなんて誰が考えただろう？Kastak ArmsのMicroid Battle Suitはエントリーレベルのアーマーセットとして最適です。セラミックプレートが重要な部分を保護し、マイクロウィーブがそれ以外の部分をカバーする。	
item_Desc_ksar_undersuit_01	アイテムタイプアンダースーツ\nダメージ軽減10%\n温度レーティング: -30 / 60 �C\n\nこのKastak Armsのベースラインアンダースーツは、要素からの完全な保護シールと複数のアーマータイプとの互換性を提供します。	
item_Desc_orig_armor_medium_helmet_01	アイテムタイプミディアム・アーマー\nダメージ軽減30%\n温度レート: -61 / 91 �C\n\n100シリーズの洗練されたスタイルにインスパイアされたGiocosoは、Origin Jumpworksにふさわしいヘルメットです。ワイドなフェイスシールドで優れた周辺視界を確保し、特殊な内部エアフローシステムで熱と湿気を逃がす。100シリーズにちなんで、ヘルメットの背面には、船の尾翼の象徴的な形状言語が巧みに組み込まれている。	
item_Desc_outlaw_legacy_armor_heavy_arms_01_01_9tails01	アイテムタイプヘビーアーマー\nダメージ軽減40%\n温度レーティング: -80 / 110 �C\n\nKastak ArmsのCitadelアームに改良を加えたバージョン。Kastak Armsの攻撃的なデザインはCitadelで頂点に達した。幾重にも張り巡らされた強化装甲が最大の安全性を提供し、角張ったシルエットは堂々たる存在感を放つ。	
item_Desc_outlaw_legacy_armor_heavy_core_01_01_9tails01	アイテムタイプヘビーアーマー\nダメージ軽減40%\nキャリー容量：4K�SCU\n温度レーティング： -80 / 110 �C\nバックパック互換性すべて\n\nKastak ArmsのCitadelコアをオリジナルから改良したバージョン。Kastak ArmsのアグレッシブなデザインはCitadelで頂点に達しました。幾重にも施された強化アーマーが最大の安全性を提供し、角張ったシルエットが堂々とした印象を与えます。	
item_Desc_outlaw_legacy_armor_light_arms_01_01_9tails01	アイテムタイプライトアーマー\nダメージ軽減率: 20%\n温度レーティング: -31 / 61 �C\n\nKastak ArmsのLynxアーマーを原型から改良したバージョン。リンクスコンバットアーマーで機動力を維持する。ハイテクポリマーで編まれたこのスーツは、危険から素早く逃れるための十分なダメージに耐えることができる。このスーツの印象的な外観は、2800年代半ばに広く人気を博した "Fire and Fury "のVIDEOでシーカーが着用したことで有名になった。	
item_Desc_outlaw_legacy_armor_light_helmet_01_01_9tails01	アイテムタイプライトアーマー\nダメージ軽減率: 20%\n温度レーティング: -31 / 61 �C\n\nKastak Armsのオラクルヘルメットを原型から改良したバージョン。Kastak Armsのオラクルヘルメットは、目の上にダイヤモンドラミネート加工を施した、密閉型の強化メッキヘルメットです。宇宙や戦場での安全性を保ちながら、最大限の状況認識を可能にする。	
item_Desc_outlaw_legacy_armor_medium_helmet_01_01_9tails01	アイテムタイプミディアム・アーマー\nダメージ軽減30%\n温度レーティング: -56 / 86 �C\n\nKastak Armsのヘルメット "Morningstar "を改造したバージョン。モーニングスターを被っている間は弱さを見せない。この完全密閉型コンバットヘルメットは様々な戦闘状況に耐え、弾道、衝撃、エネルギーなど様々な脅威から身を守る。	
item_Desc_outlaw_legacy_armor_medium_legs_01_01_9tails01	アイテムタイプミディアム・アーマー\nダメージ軽減30%\nキャリー容量：5.5K �SCU\n温度定格温度：-56 / 86\n\nKastak ArmsのInquisitorの脚を元の形から改良したバージョン。強さとスピードを併せ持つ新型アーマー。強靭でありながら軽量な合金メッキは、強化されたポリファイバー織りとともに機能し、皮膚を守りながらスピードを落とさない。Kastak Armsの威圧的な美学と組み合わせると、このミディアムアーマーが帝国全土で悪名高いものになった理由がよくわかる。	
item_Desc_outlaw_legacy_heavy_armor	アイテムタイプヘビーアーマー\nダメージ軽減40%\n温度レーティング: -80 / 110 �C\n\nKastak ArmsのアグレッシブなデザインはCitadelで頂点に達した。幾重にも施された強化装甲が最大限の安全性を提供し、角張ったシルエットが印象的。	
item_Desc_outlaw_legacy_heavy_armor_arms_02	アイテムタイプヘビーアーマー\nダメージ軽減40%\n温度レーティング: -80 / 110 �C\n\nKastak ArmsのアグレッシブなデザインはCitadelで頂点に達した。幾重にも施された強化アーマーが最大限の安全性を提供し、角ばったシルエットが印象的なシタデル-SE。シタデル-SEは、胸部プレートにスタイリッシュな文字があしらわれ、ナノコンポジットバリスティックマテリアルの採用により、最高のプロテクションを提供します。	
item_Desc_outlaw_legacy_heavy_armor_core	アイテムタイプヘビーアーマー\nダメージ軽減40%\nキャリー容量：4K�SCU\n温度レーティング： -80 / 110 �C\nバックパック互換性すべて\n\nKastak ArmsのアグレッシブなデザインはCitadelで頂点に達しました。幾重にも施された強化アーマーが最大限の安全性を提供し、角ばったシルエットが堂々とした印象を与えます。	
item_Desc_outlaw_legacy_heavy_armor_core_02	アイテムタイプヘビーアーマー\nダメージ軽減40%\nキャリー容量：10.5k�SCU\n温度定格温度：-80 / 110\nバックパックとの互換性すべて\n\nKastak ArmsのアグレッシブなデザインはCitadelで頂点に達しました。幾重にも施された強化アーマーが最大の安全性を提供し、角ばったシルエットが堂々とした印象を与えます。シタデル-SEは、フロントチェストプレートにスタイリッシュな文字があしらわれ、高度なナノコンポジットバリスティック素材により、最高のプロテクションを提供します。	
item_Desc_outlaw_legacy_heavy_armor_helmet	アイテムタイプヘビーアーマー\nダメージ軽減40%\n温度レーティング: -80 / 110 �C\n\nFortifierで最も貴重な資産を守りましょう。非常に過酷な環境を想定したこの重いヘルメットは、首と後頭部を保護する追加メッキにより、視界の狭さを補っています。	
item_Desc_outlaw_legacy_heavy_armor_helmet_neoni	アイテムタイプヘビーアーマー\nダメージ軽減40%\n温度レーティング: -80 / 110 �C\n\nFortifierヘルメットのNeoniモディファイで、主君に仕えないことを示そう。古代の神話からインスピレーションを得た、Kastak Arms Fortifierのこの威嚇的なバリエーションは、悪魔的な塗装、牙だらけの笑み、尖った角が特徴です。保護と威嚇を兼ね備えた、思い出に残るヘルメットです。	
item_Desc_outlaw_legacy_heavy_armor_legs	アイテムタイプヘビーアーマー\nダメージ軽減40%\nキャリー容量：6.5k�SCU\n温度定格温度：-80 / 110\n\nKastak ArmsのアグレッシブなデザインはCitadelで頂点に達した。幾重にも施された強化装甲が最大限の安全性を提供し、角ばったシルエットが堂々とした存在感を放つ。	
item_Desc_outlaw_legacy_heavy_armor_legs_02	アイテムタイプヘビーアーマー\nダメージ軽減40%\nキャリー容量：6.5k�SCU\n温度定格温度：-80 / 110\n\nKastak ArmsのアグレッシブなデザインはCitadelで頂点に達した。幾重にも施された強化装甲が最大限の安全性を確保し、角ばったシルエットが印象的なシタデル-SE。シタデル-SEは、胸部プレートにスタイリッシュな文字があしらわれ、ナノコンポジットバリスティックマテリアルの採用により、最高のプロテクションを提供します。	
item_Desc_outlaw_legacy_light_armor	アイテムタイプライトアーマー\nダメージ軽減率: 20%\n温度レーティング: -31 / 61 �C\n\nリンクスのコンバットアーマーで機動力を維持しよう。ハイテクのポリマー織物により、着用者は危険から素早く逃れるために十分なダメージに耐えることができる。このスーツは2800年代半ばに放映された "Fire and Fury "でシーカーが着用したことで有名になった。	
item_Desc_outlaw_legacy_light_armor_core	アイテムタイプライトアーマー\nダメージ軽減率：20\nキャリー容量：8K�SCU\n温度耐温度： -31 / 61\nバックパック互換性ライト\n\nリンクスコンバットアーマーで機動力を維持。ハイテクのポリマー織物により、危険から素早く逃れるための十分なダメージに耐えることができる。このスーツの印象的な外観は、2800年代半ばに広く人気を博した "Fire and Fury "のVIDEOでシーカーが着用したことで有名になった。	
item_Desc_outlaw_legacy_light_armor_helmet	アイテムタイプライトアーマー\nダメージ軽減率: 20%\n温度レーティング: -31 / 61 �C\n\nKastak ArmsのOracleは、目の上にダイヤモンドラミネート加工が施された密閉型強化メッキヘルメットです。宇宙や戦場での安全性を保ちながら、最大限の状況認識を可能にする。	
item_Desc_outlaw_legacy_light_armor_legs	アイテムタイプライトアーマー\nダメージ軽減率：20\n携帯能力：5K�SCU\n温度定格温度：-31 / 61\n\nリンクス コンバット アーマーで機動力を維持。ハイテクポリマー織りで、危険から素早く脱出するための十分なダメージに耐えることができる。このスーツは2800年代半ばに放映された "Fire and Fury "でシーカーが着用したことで有名になった。	
item_Desc_outlaw_legacy_medium_armor	アイテムタイプミディアム・アーマー\nダメージ軽減30%\n温度レーティング: -56 / 86 �C\n\n強さとスピードが融合した新しいインクイジターアーマーセット。強靭でありながら軽量な合金メッキは、強化ポリファイバー織りとともに、皮膚を守りながらスピードを落とさないように機能する。Kastak Armsの威圧的な美学と組み合わせれば、このミディアムアーマーが帝国全土で悪名高いものになった理由が容易にわかるだろう。	
item_Desc_outlaw_legacy_medium_armor_core	アイテムタイプミディアム・アーマー\nダメージ軽減30%\nキャリー容量：8.5K �SCU\n温度定格温度：-56 / 86\nバックパックとの互換性ライト	
item_Desc_outlaw_legacy_medium_armor_helmet	アイテムタイプミディアム・アーマー\nダメージ軽減30%\n温度レーティング: -56 / 86 �C\n\nモーニングスターを被っている間、弱さを見せるな。この完全密閉型コンバットヘルメットは、様々な戦闘状況に対応し、弾道、衝撃、エネルギーなど様々な脅威から身を守る。	
item_Desc_outlaw_legacy_medium_armor_legs	アイテムタイプミディアム・アーマー\nダメージ軽減30%\nキャリー容量：5.5K �SCU\n温度定格温度：-56 / 86\n\n強さとスピードが融合した新しいインクイジターアーマーセット。強靭でありながら軽量な合金メッキは、強化ポリファイバー編みと相まって、あなたの肌を守り、スピードを落とさない。Kastak Armsの威圧的な美学と組み合わせれば、このミディアムアーマーが帝国全土で悪名高いものになった理由が容易にわかるだろう。	
item_Desc_qrt_mantis_undersuit_01_01_01	アイテムタイプアンダースーツ\nダメージ軽減10%\n温度レーティング: -40 / 40 �C\n\nSabineはQuirinus Techに期待される先進的な外観とパフォーマンスを体現している。この最先端のアンダースーツは、軽量でありながらプロテクションを提供するために、強靭でありながら柔軟なマイクロウィーブと、戦略的に配置されたメッキが一体化している。洗練されたデザインのSabineアンダースーツは、どんな状況でも安全でスタイリッシュな走りを約束する。	
item_Desc_qrt_mantis_undersuit_helmet_01_01_01	アイテムタイプフライト・ヘルメット\nダメージ軽減10%\n温度レーティング: -40 / 40 �C\n\nQuirinus TechのCalvaヘルメットで、周囲をクリアに見渡そう。独自の合成サファイアを使用した大型フェイスシールドは、一般的な素材と同等の薄さと軽さを保ちながら、耐傷性を発揮します。	
item_Desc_qrt_specialist_medium_arms_01	アイテムタイプミディアム・アーマー\nダメージ軽減30%\n温度レート: -61 / 91 �C\n\n耐久性と印象的なスタイルを融合させたArtimexアーマーは、Quirinusの美学を体現している。ネオンカラーの眼が特徴的なヘルメットとの組み合わせは、フォルムと機能の両方を考慮した複雑なディテールのアーマーである。このアーマーには、ヘルメットの上に扇状に広がるユニークなカウルや、膝丈のフィットしたケープも付属している。	
item_Desc_qrt_specialist_medium_arms_01_01_9tails01	アイテムタイプミディアム・アーマー\nダメージ軽減30%\n温度レート: -61 / 91 �C\n\nQuirinus TechのArtimexアーマーをオリジナルから改良したバージョン。耐久性と印象的なスタイルを融合させたArtimexアーマーは、Quirinusの美学を体現している。この複雑なディテールのアーマーは形と機能の両方を考慮し、特にネオンの眼光を特徴とする完全密閉型ヘルメットと組み合わせるとより効果的である。このアーマーには、ヘルメットの上に扇状に広がるユニークなカウルや、膝丈のフィットしたケープも付属している。	
item_Desc_qrt_specialist_medium_arms_02	アイテムタイプミディアム・アーマー\nダメージ軽減30%\n温度レート: -61 / 91 �C\n\n耐久性と印象的なスタイルを融合させたArtimexアーマーは、Quirinusの美学を体現している。ネオンカラーの眼が特徴的なヘルメットとの組み合わせは、フォルムと機能の両方を考慮した複雑なディテールのアーマーである。このアーマーには、ヘルメットの上に扇状に広がるユニークなカウルや、膝丈のフィットしたケープも付属している。ハーストン・ダイナミクス版は、同社のエグゼクティブ・セキュリティ・チームのために特別に作られた。	
item_Desc_qrt_specialist_medium_core_01	アイテムタイプミディアム・アーマー\nダメージ軽減30%\nキャリー容量：8.5K �SCU\n温度定格温度：-61 / 91\nバックパックとの互換性ライト	
item_Desc_qrt_specialist_medium_core_01_01_9tails01	アイテムタイプミディアム・アーマー\nダメージ軽減30%\nキャリー容量：8.5K �SCU\n温度定格温度：-61 / 91\nバックパックとの互換性ライト	
item_Desc_qrt_specialist_medium_core_02	アイテムタイプミディアム・アーマー\nダメージ軽減30%\nキャリー容量：8.5K �SCU\n温度定格温度：-61 / 91\nバックパックとの互換性ライト	
item_Desc_qrt_specialist_medium_helmet_01	アイテムタイプミディアム・アーマー\nダメージ軽減30%\n温度レート: -61 / 91 �C\n\n耐久性と印象的なスタイルを融合させたArtimexアーマーは、Quirinusの美学を体現している。ネオンカラーの眼が特徴的なヘルメットとの組み合わせは、フォルムと機能の両方を考慮した複雑なディテールのアーマーである。このアーマーには、ヘルメットの上に扇状に広がるユニークなカウルや、膝丈のフィットしたケープも付属している。	
item_Desc_qrt_specialist_medium_helmet_02	アイテムタイプミディアム・アーマー\nダメージ軽減30%\n温度レート: -61 / 91 �C\n\n耐久性と印象的なスタイルを融合させたArtimexアーマーは、Quirinusの美学を体現している。ネオンカラーの眼が特徴的なヘルメットとの組み合わせは、フォルムと機能の両方を考慮した複雑なディテールのアーマーである。このアーマーには、ヘルメットの上に扇状に広がるユニークなカウルや、膝丈のフィットしたケープも付属している。ハーストン・ダイナミクス版は、同社のエグゼクティブ・セキュリティ・チームのために特別に作られた。	
item_Desc_qrt_specialist_medium_legs_01	アイテムタイプミディアム・アーマー\nダメージ軽減30%\nキャリー容量：5.5K �SCU\n温度定格温度：-61 / 91\n\n耐久性と印象的なスタイルが融合したArtimexアーマーは、Quirinusの美学を体現しています。ネオンの眼光が特徴的なヘルメットとの組み合わせは、フォルムと機能の両方を考慮した複雑なディテールとなっている。このアーマーには、ヘルメットの上に扇状に広がるユニークなカウルや、膝丈のフィットしたケープも付属している。	
item_Desc_qrt_specialist_medium_legs_02	アイテムタイプミディアム・アーマー\nダメージ軽減30%\nキャリー容量：5.5K �SCU\n温度定格温度：-61 / 91\n\n耐久性と印象的なスタイルが融合したArtimexアーマーは、Quirinusの美学を体現しています。ネオンの眼光が特徴的なヘルメットとの組み合わせは、フォルムと機能の両方を考慮した複雑なディテールとなっている。このアーマーには、ヘルメットの上に扇状に広がるユニークなカウルや、膝丈のフィットしたケープも付属している。ハーストン・ダイナミクス版は、同社のエグゼクティブ・セキュリティ・チームのために特別に作られた。	
item_Desc_r6p_boots_04_01_01	R6 Proのトレイル仕様のCerradoブーツは、快適で防水性に優れ、長持ちするように作られている。背の高い履き口と上部の紐は、足首のサポートと安定性をシームレスに組み合わせている。	
item_Desc_r6p_boots_05	天然皮革と人工皮革を独自にブレンドすることで、タソックブーツは比類のないタフネスを備え、仕事にもレジャーにも最適です。	
item_Desc_r6p_gloves_02_01_01	手先の器用さを犠牲にすることなく手を安全に保つことができる耐滑性に優れたアスター・グローブは、肌寒いときや過酷な状況下でもしっかりとしたプロテクションと持続する保温性を提供する。丈夫な合成皮革はよく馴染み、長年の頻繁な使用に耐える。	
item_Desc_rrs_combat_heavy_backpack_01	アイテムタイプヘビーバックパック\n耐荷重： 100K �SCU\nコア適合性：ヘビー\n\nモロゾフCHバックパックは、重要なギアを快適に持ち運ぶことができます。このソフトシェルバッグは、軽量でありながら戦場での使用に耐えるデュラウィーブを採用しています。また、アクセスしやすいポケットと豊富なストラップで、補給品をしっかりと背中に固定することができます。	
item_Desc_rrs_combat_heavy_backpack_01_01_9tails01	アイテムタイプヘビーバックパック\n耐荷重： 100K �SCU\nコア適合性：ヘビー\n\nルシモフ・リハビリテーション・システムズのモロゾフCHバックパックを改良したバージョン。モロゾフCHバックパックは、重要なギアを快適に持ち運ぶことができます。このソフトシェルバッグは、軽量でありながら戦場での使用に耐える高度なデュラウィーブで作られています。また、アクセスしやすいポケットと豊富なストラップで、補給品をしっかりと背中に固定することができます。	
item_Desc_rrs_combat_heavy_backpack_01_crus01_01	アイテムタイプヘビーバックパック\n耐荷重： 100K �SCU\nコア適合性：ヘビー\n\nモロゾフCHバックパックは、重要なギアを快適に持ち運ぶことができます。このソフトシェルバッグは、軽量でありながら戦場での使用に耐えるデュラウィーブを採用しています。また、アクセスしやすいポケットと豊富なストラップで、補給品をしっかりと背中に固定することができます。クルセイダー・エディションは、警備会社のために特別に作られた。	
item_Desc_rrs_combat_heavy_backpack_02	アイテムタイプヘビーバックパック\n耐荷重： 100K �SCU\nコア適合性：ヘビー\n\nモロゾフCHバックパックは、重要なギアを快適に持ち運ぶことができます。このソフトシェルバッグは、軽量でありながら戦場での使用に耐えるデュラウィーブを採用しています。また、アクセスしやすいポケットと豊富なストラップで、補給品をしっかりと背中に固定することができます。	
item_Desc_rrs_combat_heavy_backpack_03	アイテムタイプヘビーバックパック\n耐荷重： 100K �SCU\nコア適合性：ヘビー\n\nモロゾフCHバックパックは、重要なギアを快適に持ち運ぶことができます。このソフトシェルバッグは、軽量でありながら戦場での使用に耐えるデュラウィーブを採用しています。また、アクセスしやすいポケットと豊富なストラップで、補給品をしっかりと背中に固定することができます。	
item_Desc_rrs_combat_heavy_backpack_04_01_01	アイテムタイプヘビーバックパック\n耐荷重： 100K �SCU\nコア適合性：ヘビー\n\nRRSモロゾフ-CHバックパックで、重要なギアを快適に持ち運びましょう。このソフトシェルバッグは、軽量でありながら、あらゆる産業作業に対応するデュラウィーブで作られています。また、アクセスしやすいポケットと豊富なストラップで、物資をしっかりと背中に固定することができる。Pyrotechnic Amalgamated Editionは、26世紀のパイロでの採掘活動のために特別に作られた。	
item_Desc_rrs_combat_heavy_backpack_04_02_01	アイテムタイプヘビーバックパック\n耐荷重： 100K �SCU\nコア適合性：ヘビー\n\nRRSモロゾフ-CHバックパックで、重要なギアを快適に持ち運びましょう。このソフトシェルバッグは、軽量でありながら、あらゆる産業作業に対応するデュラウィーブで作られています。また、アクセスしやすいポケットと豊富なストラップで、補給品をしっかりと背中に固定することができる。ゴールド・ホライズン・エディションは、26世紀のパイロでの事業用に特別に作られた。	
item_Desc_rrs_combat_light_backpack_01	アイテムタイプライトバックパック\n容量： 40K �SCU\nコアの互換性すべて\n\nArden-CLバックパックは、戦闘地域へ物資を運ぶにも、単に余分なギアを運ぶにも、戦闘準備とテストが整っています。ルシモフ・リハビリテーション・システムズは、様々なアーマーに取り付け可能なユニバーサルコアコネクターを採用したバックパックを設計しました。	
item_Desc_rrs_specialist_heavy_arms_01	アイテムタイプヘビーアーマー\nダメージ軽減40%\n温度レーティング: -90 / 115 �C\n\nモロゾフ-SHは、強化されたアーマープレーティング、特殊なアンチリッププロテクトパッド、そして十分な収納を特徴とし、あらゆる逆境に打ち勝つ準備ができています。RRSはセキュリティの専門家と相談し、彼らの推奨に基づき、独自の高い保護襟と軽量インナーを追加しました。	
item_Desc_rrs_specialist_heavy_arms_01_01_9tails01	アイテムタイプヘビーアーマー\nダメージ軽減40%\n温度レーティング: -70 / 100 �C\n\nルシモフ・リハビリテーション・システムズのモロゾフ-SHアームを改良したバージョン。強化された装甲メッキ、特殊剥離防止保護パッド、十分な収納スペースを備え、モロゾフ-SHはあらゆる逆境を克服する準備ができています。セキュリティの専門家と相談し、RRSは彼らの推薦に基づき、独自の高い保護襟と軽量インナーを追加した。	
item_Desc_rrs_specialist_heavy_arms_02	アイテムタイプヘビーアーマー\nダメージ軽減40%\n温度レーティング: -95 / 120 �C\n\nモロゾフ-SHは、強化されたアーマープレーティング、特殊なアンチリッププロテクトパッド、そして十分な収納を特徴とし、あらゆる逆境に打ち勝つ準備ができています。セキュリティの専門家と相談し、RRSはユニークな高い保護襟と軽量インナーを追加しました。	
item_Desc_rrs_specialist_heavy_arms_03	アイテムタイプヘビーアーマー\nダメージ軽減40%\n温度レーティング: -97 / 121 �C\n\nモロゾフ-SHは、強化されたアーマープレーティング、特殊なアンチリッププロテクトパッド、そして十分な収納を特徴とし、あらゆる逆境に打ち勝つ準備ができています。セキュリティの専門家と相談し、RRSはユニークな高い保護襟と軽量インナーを追加しました。	
item_Desc_rrs_specialist_heavy_arms_04_01_01	アイテムタイプヘビーアーマー\nダメージ軽減40%\n温度レーティング: -70 / 100 �C\n\nモロゾフSHと同じ強化アーマープレーティング、アンチリッププロテクションパッド、豊富な収納を備えたSH-I産業用バリエーションは、RRS社により、敵対地帯で働く労働者を保護し、職務遂行に必要な可動域を確保するために設計された。パイロテクニック・アマルゲーテッド・エディションは、26世紀のパイロでの採掘活動のために特別に作られた。	
item_Desc_rrs_specialist_heavy_arms_04_02_01	アイテムタイプヘビーアーマー\nダメージ軽減40%\n温度レーティング: -70 / 100 �C\n\nモロゾフSHと同様の強固な装甲メッキ、特殊防滴パッド、豊富な収納スペースを備えた産業用SH-Iは、RRS社により、敵地で働く労働者を保護しつつ、業務に必要な可動域を確保するために設計された。ゴールド・ホライズン・エディションは、26世紀のパイロでの事業用に特別に作られた。	
item_Desc_rrs_specialist_heavy_core_01	アイテムタイプヘビーアーマー\nダメージ軽減40%\nキャリー容量：12K�SCU\n温度レーティング： -90 / 115 �C\nバックパック互換性すべて\n\nモロゾフ-SHは、強化アーマープレーティング、アンチリッププロテクションパッド、豊富な収納を特徴とし、あらゆる逆境を克服する準備ができています。RRSはセキュリティの専門家と相談し、彼らの推奨に基づき、独自の高い保護襟と軽量インナーを追加しました。	
item_Desc_rrs_specialist_heavy_core_01_01_9tails01	アイテムタイプヘビーアーマー\nダメージ軽減40%\nキャリー容量：10.5K �SCU\n温度定格温度：-70 / 100\nバックパックとの互換性すべて\n\nルシモフ・リハビリテーション・システムズのモロゾフ-SHコアを改良したバージョン。強化されたアーマープレーティング、特殊なアンチリッププロテクトパッド、十分な収納を特徴とするモロゾフ-SHは、あらゆる逆境を克服する準備ができています。RRSはセキュリティの専門家と相談した結果、彼らの推奨に基づき、独自の高い保護襟と軽量インナーを追加し、モロゾフ-SHを快適かつ戦場の強い味方にしている。	
item_Desc_rrs_specialist_heavy_core_01_crus01_01	アイテムタイプヘビーアーマー\nダメージ軽減40%\nキャリー容量：12K�SCU\n温度レーティング： -90 / 115 �C\nバックパック互換性すべて\n\nモロゾフ-SHは、強化アーマープレーティング、アンチリッププロテクションパッド、豊富な収納を特徴とし、あらゆる逆境を克服する準備ができています。RRSはセキュリティの専門家と相談し、彼らの推奨に基づき、独自の高い保護襟と軽量インナーを追加しました。クルセイダー・エディションは、警備会社のために特別に作られた。	
item_Desc_rrs_specialist_heavy_core_02	アイテムタイプヘビーアーマー\nダメージ軽減40%\nキャリー容量：12K�SCU\n温度定格：-95 / 120 �C\nバックパックとの互換性すべて\n\nモロゾフ-SHは、強化アーマープレーティング、アンチリッププロテクションパッド、豊富な収納を特徴とし、あらゆる逆境を克服する準備ができています。セキュリティの専門家と相談し、RRSはユニークな高い保護襟と軽量インナーを追加しました。	
item_Desc_rrs_specialist_heavy_core_03	アイテムタイプヘビーアーマー\nダメージ軽減40%\nキャリー容量：12K�SCU\n温度定格温度: -97 / 121 °C\nバックパック互換性すべて\n\nモロゾフ-SHは、強化されたアーマープレーティング、特殊なアンチリッププロテクトパッド、豊富な収納を特徴とし、あらゆる逆境を克服する準備ができています。セキュリティの専門家と相談し、RRSは独自の高い保護襟と軽量インナーを追加しました。	
item_Desc_rrs_specialist_heavy_core_04_01_01	アイテムタイプヘビーアーマー\nダメージ軽減40%\nキャリー容量：10.5K �SCU\n温度定格温度: -75 / 105 °C\n\nモロゾフSHと同じ強化装甲、特殊防滴パッド、豊富な収納を備えたSH-I産業用バリエーションは、敵地で働く労働者を保護し、職務遂行に必要な可動域を確保するためにRRSによって設計された。パイロテクニック・アマルゲーテッド・エディションは、26世紀のパイロでの採掘活動のために特別に作られた。	
item_Desc_rrs_specialist_heavy_core_04_02_01	アイテムタイプヘビーアーマー\nダメージ軽減40%\nキャリー容量：10.5K �SCU\n温度定格温度: -75 / 105 °C\n\nモロゾフSHと同じ強化装甲、特殊防滴パッド、豊富な収納スペースを備えたSH-I産業用モデルは、敵地で働く労働者を保護し、業務に必要な可動域を確保するためにRRS社によって設計された。ゴールド・ホライズン・エディションは、26世紀のパイロでの事業用に特別に作られた。	
item_Desc_rrs_specialist_heavy_helmet_01	アイテムタイプヘビーアーマー\nダメージ軽減40%\n温度レーティング: -90 / 115 �C\n\nモロゾフ-SHは、強化されたアーマープレーティング、特殊なアンチリッププロテクトパッド、そして十分な収納を特徴とし、あらゆる逆境に打ち勝つ準備ができています。RRSはセキュリティの専門家と相談し、彼らの推奨に基づき、独自の高い保護襟と軽量インナーを追加しました。	
item_Desc_rrs_specialist_heavy_helmet_02	アイテムタイプヘビーアーマー\nダメージ軽減40%\n温度レーティング: -95 / 120 �C\n\nモロゾフ-SHは、強化されたアーマープレーティング、特殊なアンチリッププロテクトパッド、そして十分な収納を特徴とし、あらゆる逆境に打ち勝つ準備ができています。セキュリティの専門家と相談し、RRSはユニークな高い保護襟と軽量インナーを追加しました。	
item_Desc_rrs_specialist_heavy_helmet_03	アイテムタイプヘビーアーマー\nダメージ軽減40%\n温度レーティング: -97 / 121 �C\n\nモロゾフ-SHは、強化されたアーマープレーティング、特殊なアンチリッププロテクトパッド、そして十分な収納を特徴とし、あらゆる逆境に打ち勝つ準備ができています。セキュリティの専門家と相談し、RRSはユニークな高い保護襟と軽量インナーを追加しました。	
item_Desc_rrs_specialist_heavy_helmet_03_crus01_01	アイテムタイプヘビーアーマー\nダメージ軽減40%\n温度レーティング: -97 / 121 �C\n\nモロゾフ-SHは、強化されたアーマープレーティング、特殊なアンチリッププロテクトパッド、そして十分な収納を特徴とし、あらゆる逆境に打ち勝つ準備ができています。RRSはセキュリティの専門家と相談し、独自の高い保護襟と軽量インナーを追加した。クルセイダー・エディションは、警備会社のために特別に作られた。	
item_Desc_rrs_specialist_heavy_helmet_04_01_01	アイテムタイプヘビーアーマー\nダメージ軽減40%\n温度レーティング: -70 / 100 �C\n\nモロゾフSHと同じ強化アーマープレーティング、アンチリッププロテクションパッド、豊富な収納を備えたSH-I産業用バリエーションは、RRS社により、敵対地帯で働く労働者を保護し、職務遂行に必要な可動域を確保するために設計された。パイロテクニック・アマルゲーテッド・エディションは、26世紀のパイロでの採掘活動のために特別に作られた。	
item_Desc_rrs_specialist_heavy_helmet_04_02_01	アイテムタイプヘビーアーマー\nダメージ軽減40%\n温度レーティング: -70 / 100 �C\n\nモロゾフSHと同様の強固な装甲メッキ、特殊防滴パッド、豊富な収納スペースを備えた産業用SH-Iは、RRS社により、敵地で働く労働者を保護しつつ、業務に必要な可動域を確保するために設計された。ゴールド・ホライズン・エディションは、26世紀のパイロでの事業用に特別に作られた。	
item_Desc_rrs_specialist_heavy_legs_01	アイテムタイプヘビーアーマー\nダメージ軽減40%\nキャリー容量：7.5K �SCU\n温度定格温度：-90 / 115\n\n強化された装甲メッキ、特殊防滴パッド、十分な収納力を備えたモロゾフ-SHは、あらゆる逆境に打ち勝つ準備ができています。RRSはセキュリティの専門家と相談し、彼らの推奨に基づき、独自の高い保護襟と軽量なインナーを追加しました。	
item_Desc_rrs_specialist_heavy_legs_01_01_9tails01	アイテムタイプヘビーアーマー\nダメージ軽減40%\nキャリー容量：6.5K �SCU\n温度定格温度：-70 / 100\n\nルシモフ・リハビリテーション・システムズのモロゾフ-SH脚を改良したバージョン。強化された装甲メッキ、特殊防錆パッド、十分な収納スペースを備え、あらゆる逆境に対応します。セキュリティの専門家と相談し、RRSは彼らの推薦に基づき、独自の高い保護襟と軽量インナーを追加した。	
item_Desc_rrs_specialist_heavy_legs_01_crus01_01	アイテムタイプヘビーアーマー\nダメージ軽減40%\nキャリー容量：7.5K �SCU\n温度定格温度：-90 / 115\n\n強化された装甲メッキ、特殊防滴パッド、十分な収納力を備えたモロゾフ-SHは、あらゆる逆境に打ち勝つ準備ができています。RRSはセキュリティの専門家と相談し、彼らの推奨に基づき、独自の高い保護襟と軽量インナーを追加した。クルセイダー・エディションは、警備会社のために特別に作られた。	
item_Desc_rrs_specialist_heavy_legs_02	アイテムタイプヘビーアーマー\nダメージ軽減40%\nキャリー容量：7.5K �SCU\n温度定格温度：-95 / 120\n\n強化アーマープレーティング、アンチリッププロテクションパッド、豊富な収納を備えたモロゾフ-SHは、あらゆる逆境に打ち勝つ準備ができています。セキュリティの専門家と相談し、RRSはユニークな高い保護襟と軽量インナーを追加しました。	
item_Desc_rrs_specialist_heavy_legs_03	アイテムタイプヘビーアーマー\nダメージ軽減40%\nキャリー容量：7.5K �SCU\n温度定格温度: -97 / 121 °C\n\n強化されたアーマープレーティング、特殊なアンチリッププロテクトパッド、十分な収納を備えたモロゾフ-SHは、あらゆる逆境に打ち勝つ準備ができています。セキュリティの専門家と相談し、RRSはユニークな高い保護襟と軽量インナーを追加しました。	
item_Desc_rrs_specialist_heavy_legs_04_01_01	アイテムタイプヘビーアーマー\nダメージ軽減40%\nキャリー容量：6.5K �SCU\n温度定格温度：-70 / 100\n\nモロゾフSHと同じ強化装甲、特殊防滴パッド、豊富な収納を備えたSH-I産業用バリエーションは、敵地で働く労働者を保護し、職務遂行に必要な可動域を確保するためにRRSによって設計された。パイロテクニック・アマルゲーテッド・エディションは、26世紀のパイロでの採掘活動のために特別に作られた。	
item_Desc_rrs_specialist_heavy_legs_04_02_01	アイテムタイプヘビーアーマー\nダメージ軽減40%\nキャリー容量：6.5K �SCU\n温度定格温度：-70 / 100\n\nモロゾフSHと同じ強化装甲、特殊防滴パッド、豊富な収納スペースを備えたSH-I産業用モデルは、RRS社により、敵地での業務に従事する労働者を保護し、業務に必要な可動域を確保するために設計された。ゴールド・ホライズン・エディションは、26世紀のパイロでの事業用に特別に作られた。	
item_Desc_rrs_specialist_light_arms_01	アイテムタイプライトアーマー\nダメージ軽減率: 20%\n温度レーティング: -38 / 68 °C\n\nその優れたデザインと人目を引くスタイルで、Arden-SLアーマーは、セキュリティスペシャリストがなぜRoussimoffリハビリテーションシステムを愛するかを例証しています。この万能アーマーセットは、特殊複合装甲メッキとファブリックの正確な配置のおかげで、着用者が機敏でありながら安全であることを可能にします。	
item_Desc_rrs_specialist_light_arms_01_crus01_01	アイテムタイプライトアーマー\nダメージ軽減率: 20%\n温度レーティング: -38 / 68 °C\n\nその優れたデザインと人目を引くスタイルで、Arden-SLアーマーは、セキュリティスペシャリストがなぜRoussimoffリハビリテーションシステムを愛するかを例証しています。この万能アーマーセットは、特殊な複合アーマープレーティングとファブリックの正確な配置のおかげで、着用者は機敏でありながら安全な状態を保つことができます。クルセイダー・エディションは、同社のセキュリティ・サービスのために特別に作られた。	
item_Desc_rrs_specialist_light_core_01	アイテムタイプライトアーマー\nダメージ軽減率: 20%\nキャリー容量：8K µSCU\n温度定格温度: -35 / 68 °C\nバックパックの互換性ライト\n\n優れたデザインと人目を引くスタイルが特徴のArden-SLアーマーは、セキュリティのスペシャリストがなぜRoussimoff Rehabilitation Systemsを愛用するのかを体現しています。この万能アーマーセットは、特殊複合アーマープレーティングとファブリックの正確な配置のおかげで、着用者が機敏でありながら安全であることを可能にします。また、重要な装備に簡単にアクセスできるツールベルトも特徴です。	
item_Desc_rrs_specialist_light_core_01_01_9tails01	アイテムタイプライトアーマー\nダメージ軽減率: 20%\nキャリー容量：8K µSCU\n温度定格温度: -35 / 68 °C\nバックパックの互換性ライト\n\nRoussimoff Rehabilitation SystemsのArden-SLコアをオリジナルから改良したバージョン。優れたデザインと人目を引くスタイルで、Arden-SLアーマーは、セキュリティのスペシャリストがなぜRoussimoff Rehabilitation Systemsを愛するかを例証しています。この多目的なアーマーセットは、特別な複合アーマープレーティングとファブリックの正確な配置のおかげで、着用者が機敏でありながら安全であることを可能にします。また、重要な装備に簡単にアクセスできるツールベルトも特徴です。	
item_Desc_rrs_specialist_light_helmet_01	アイテムタイプライトアーマー\nダメージ軽減率: 20%\n温度レーティング: -38 / 68 °C\n\nその優れたデザインと人目を引くスタイルで、Arden-SLアーマーは、セキュリティスペシャリストがなぜRoussimoffリハビリテーションシステムを愛するかを例証しています。この汎用性の高いアーマーセットは、特殊な複合アーマープレーティングとファブリックの正確な配置のおかげで、着用者が機敏でありながら安全に滞在することができます。また、カウル一体型の完全密閉型ヘルメットも特徴です。	
item_Desc_rrs_specialist_light_helmet_01_01_9tails01	アイテムタイプライトアーマー\nダメージ軽減率: 20%\n温度レーティング: -38 / 68 °C\n\nルーシモフ・リハビリテーション・システムズのArden-SLヘルメットをオリジナルから改良したバージョン。優れたデザインと人目を引くスタイルで、Arden-SLアーマーは、セキュリティのスペシャリストがRoussimoff Rehabilitation Systemsを愛する理由を体現しています。この多目的アーマーセットは、特殊複合アーマーメッキとファブリックの正確な配置のおかげで、着用者が機敏でありながら安全であることを可能にします。また、カウル一体型の完全密閉型ヘルメットも特徴です。	
item_Desc_rrs_specialist_light_legs_01	アイテムタイプライトアーマー\nダメージ軽減率: 20%\nキャリー容量：5K µSCU\n温度レート: -38 / 68 °C\n\n優れたデザインと人目を引くスタイルを持つArden-SLアーマーは、セキュリティのスペシャリストがなぜRoussimoff Rehabilitation Systemsを愛するのかを例証しています。この多目的な装甲セットは特別な合成の装甲めっきおよび生地の精密な配置のおかげで身に着ける人を敏捷しかし安全にとどまらせます。	
item_Desc_rsi_deckcrew_light_armor_01_Shared	アイテムタイプライトアーマー\nダメージ軽減率: 20%\n温度レーティング: -37 / 67 �C\n\nプラネットサイドでも真空中でも、RSIのMacFlex工業用アーマーセットがあなたをサポートします。補強されたメッキにより、環境危険から身を守り、豊富なポーチによりツールへのアクセスを確保します。	
item_Desc_rsi_deckcrew_light_armor_01_core	アイテムタイプライトアーマー\nダメージ軽減率：20\nキャリー容量：9K�SCU\n温度耐温度： -37 / 67\nバックパック互換性ライト\n\n惑星でも真空中でも、RSIのMacFlex工業用アーマーセットはあなたをサポートします。補強されたメッキにより、環境危険から身を守り、豊富なポーチによりツールへのアクセスを確保します。	
item_Desc_rsi_deckcrew_light_armor_01_legs	アイテムタイプライトアーマー\nダメージ軽減率：20\nキャリー容量：6K�SCU\n温度定格温度：-37 / 67\n\nプラネットサイドでも真空中でも、RSIのマックフレックス工業用アーマーセットはあなたをサポートします。補強されたメッキにより、環境からの危険から身を守り、豊富なポーチによりツールへのアクセスを確保します。	
item_Desc_rsi_deckcrew_light_armor_01_ruso_Shared	アイテムタイプライトアーマー\nダメージ軽減率: 20%\n温度レーティング: -37 / 67 �C\n\nプラネットサイドでも真空中でも、RSIのMacFlexインダストリアルアーマーセットがあなたをサポートします。補強されたメッキにより、環境の危険から身を守り、豊富なポーチによりツールへのアクセスを確保します。ラスト・ソサエティ版では、ブルーカラーの労働者を称え、汚れや磨耗を隠す赤と褐色のカラーリングが施されている。	
item_Desc_rsi_deckcrew_light_armor_01_ruso_core	アイテムタイプライトアーマー\nダメージ軽減率：20\nキャリー容量：9K�SCU\n温度耐温度： -37 / 67\nバックパック互換性ライト\n\n惑星でも真空中でも、RSIのMacFlex工業用アーマーセットはあなたをサポートします。補強されたメッキにより、環境危険から身を守り、豊富なポーチによりツールへのアクセスを確保します。ラスト・ソサエティ・エディションは、ブルーカラーの労働者を称え、汚れや磨耗をよく隠す赤と褐色の独自のカラーリングが施されている。	
item_Desc_rsi_deckcrew_light_armor_01_ruso_legs	アイテムタイプライトアーマー\nダメージ軽減率：20\nキャリー容量：6K�SCU\n温度定格温度：-37 / 67\n\nプラネットサイドでも真空中でも、RSIのマックフレックス工業用アーマーセットはあなたをサポートします。補強されたメッキは、環境危険から身を守り、豊富なポーチはツールへのアクセスを確保します。ラスト・ソサエティ版では、ブルーカラーの労働者を称え、汚れや磨耗を隠す赤と褐色のカラーリングが施されている。	
item_Desc_rsi_deckcrew_light_helmet_01	アイテムタイプライトアーマー\nダメージ軽減率: 20%\n温度レーティング: -37 / 67 �C\n\nRSIのHorizonヘルメットは、耐久性と堅牢性に優れた環境対応型密閉型作業用ヘルメットです。一枚板のラミネートドームにより、非常に広い視野が得られます。サイドに取り付けられた2つのLEDライトモジュールが、作業中の視界を確保します。	
item_Desc_rsi_deckcrew_light_helmet_01_ruso	アイテムタイプライトアーマー\nダメージ軽減率: 20%\n温度レーティング: -37 / 67 �C\n\nRSIのHorizonヘルメットは、耐久性と堅牢性に優れた環境対応型密閉型作業用ヘルメットです。一枚板のラミネートドームにより、非常に広い視野が得られます。サイドに装着された2つのLEDライトモジュールが、作業中の視界を確保します。ラスト・ソサエティ・エディションは、汚れや磨耗をよく隠す赤と褐色の独自のカラーリングでブルーカラー労働者を称えている。	
item_Desc_rsi_deckcrew_undersuit_01	アイテムタイプアンダースーツ\nダメージ軽減10%\n温度レーティング: -30 / 60 �C\n\nRSIのBeaconアンダースーツは、環境と真空から完全に保護するために設計された一般的なユーティリティです。Beaconは、耐久性がありながら柔軟性のあるポリマーで作られており、様々な体型の方に自由な動きを提供します。	
item_Desc_rsi_deckcrew_undersuit_01_ruso	アイテムタイプアンダースーツ\nダメージ軽減10%\n温度レーティング: -30 / 60 �C\n\nRSIのBeaconアンダースーツは、環境と真空から完全に保護するために設計された一般的なユーティリティです。耐久性がありながら柔軟性のあるポリマーを使用したBeaconは、様々な体型に対応する自由な動きを提供する。ラスト・ソサエティ版は、汚れや磨耗をよく隠す赤と褐色の独自のカラーリングでブルーカラー労働者を称えている。	
item_Desc_rsi_explorer_01_Shared	アイテムタイプライトアーマー\nダメージ軽減率: 20%\n\nRSIのVentureは未知の世界のために作られた軽量アーマーセットです。EVA規格のプロテクションシステムで、アンダースーツは耐久性に優れたポリマー製。	
item_Desc_rsi_explorer_01_arms	アイテムタイプライトアーマー\nダメージ軽減率: 20%\n温度レーティング: -38 / 68 �C\n\nRSIのVentureは未知の世界のために作られた軽量アーマーセットです。このEVA規格のプロテクションシステムは、過酷な環境条件に耐えるよう設計された耐久性の高いポリマー織りで作られたアンダースーツと、衝撃や微粒子から身を守るアーマーパーツを特徴としています。	
item_Desc_rsi_explorer_01_core	アイテムタイプライトアーマー\nダメージ軽減率：20\nキャリー容量：9K�SCU\n温度定格温度：-38 / 68\nバックパック互換性ライト\n\nRSIのベンチャーは未知の世界のために作られた軽量アーマーセットです。このEVA規格のプロテクションシステムは、過酷な環境条件に耐えるよう設計された耐久性のあるポリマー織りのアンダースーツと、衝撃や微粒子から身を守るアーマーパーツを装備しています。	
item_Desc_rsi_explorer_01_helmet	アイテムタイプライトアーマー\nダメージ軽減率: 20%\n温度レーティング: -38 / 68 �C\n\nRSIのVentureヘルメットは耐衝撃性に優れたコンポジット製で、過酷な環境にも耐えられるように設計されています。また、アンチスカッフラミネートフェースプレートを採用し、比類のない上方視界を提供する。	
item_Desc_rsi_explorer_01_legs	アイテムタイプライトアーマー\nダメージ軽減率：20\nキャリー容量：6K�SCU\n温度定格温度：-41 / 71\n\nRSIのベンチャーは未知の世界のために作られた軽量アーマーセットです。このEVA規格のプロテクションシステムは、過酷な環境条件に耐える耐久性のあるポリマー織りで作られたアンダースーツと、衝撃や微粒子から身を守るアーマーパーツで構成されています。	
item_Desc_rsi_explorer_light_armor_01_01_centurion_Shared	アイテムタイプライトアーマー\nダメージ軽減率: 20%\n温度レーティング: -38 / 68 �C\n\nロバート・スペース・インダストリーズのベンチャー・エクスプローラー・スーツは、宇宙の危険から身を守ります。次の冒険がどこに行くかわからない人のためにデザインされたこのスーツは、機動性を犠牲にすることなく快適性と安全性を兼ね備えています。特別なボイジャー・エディションは、赤と黒の配色に白のハイライトが特徴。その結果、性能だけでなく見た目もスタイリッシュなスーツとなった。	
item_Desc_rsi_explorer_light_armor_01_01_centurion_core	アイテムタイプライトアーマー\nダメージ軽減率：20\nキャリー容量：9K�SCU\n温度定格温度：-38 / 68\nバックパック互換性ライト\n\nロバート・スペース・インダストリーズのベンチャー・エクスプローラー・スーツは、宇宙の危険から身を守ります。次の冒険がどこに行くかわからない人のためにデザインされたこのスーツは、機動性を犠牲にすることなく、快適性と安全性を兼ね備えています。特別なボイジャー・エディションは、赤と黒の配色に白のハイライトが特徴。その結果、性能だけでなく見た目もスタイリッシュなスーツとなった。	
item_Desc_rsi_explorer_light_armor_01_01_centurion_legs	アイテムタイプライトアーマー\nダメージ軽減率：20\nキャリー容量：6K�SCU\n温度定格温度：-41 / 71\n\nロバート・スペース・インダストリーズのベンチャー・エクスプローラー・スーツは、宇宙の危険から身を守ります。次の冒険がどこに行くかわからない人のために設計されたこのスーツは、機動性を犠牲にすることなく快適性と安全性を兼ね備えています。特別なボイジャー・エディションは、赤と黒の配色に白のハイライトが特徴。その結果、性能だけでなく見た目もスタイリッシュなスーツとなった。	
item_Desc_rsi_explorer_light_armor_01_01_imperator_Shared	アイテムタイプライトアーマー\nダメージ軽減率: 20%\n温度レーティング: -38 / 68 �C\n\nロバート・スペース・インダストリーズは、エレガンスと有効性を兼ね備えたベンチャー・エクスプローラー・スーツを開発しました。パスファインダー・エディションは、真空の宇宙空間で必要なすべての安全装備に加え、ゴールドのハイライトが印象的なパープルのデザインを採用。見た目も性能も兼ね備えたスーツを着たら、もう脱ぎたくなくなるかもしれません。	
item_Desc_rsi_explorer_light_armor_01_01_imperator_core	アイテムタイプライトアーマー\nダメージ軽減率：20\nキャリー容量：9K�SCU\n温度定格温度：-38 / 68\nバックパック互換性ライト\n\nロバート・スペース・インダストリーズのベンチャー・エクスプローラー・スーツは、エレガンスと有効性を兼ね備えています。パスファインダー・エディションは、真空の宇宙空間で必要な安全機能をすべて備え、ゴールドのハイライトが印象的なパープルのデザインです。見た目も性能もこれほど優れたスーツを着たら、もう脱ぎたくなくなるかもしれない。	
item_Desc_rsi_explorer_light_armor_01_01_imperator_legs	アイテムタイプライトアーマー\nダメージ軽減率：20\nキャリー容量：6K�SCU\n温度定格温度：-41 / 71\n\nロバート・スペース・インダストリーズは、エレガンスと有効性を兼ね備えたベンチャー・エクスプローラー・スーツを開発しました。パスファインダー・エディションは、真空の宇宙空間で必要なすべての安全装備に加え、ゴールドのハイライトが印象的なパープルのデザインが特徴です。見た目も性能も兼ね備えたスーツを着たら、もう脱ぎたくなくなるかもしれません。	
item_Desc_rsi_explorer_light_armor_01_concierge_Shared	アイテムタイプライトアーマー\nダメージ軽減率: 20%\n温度レーティング: -38 / 68 �C\n\nロバート・スペース・インダストリーズのベンチャー・エクスプローラー・スーツは、新たなフロンティアを開拓する時も、長い宇宙飛行の後に足を伸ばす時も、トップクラスの安全機能と驚異的な自由度をシームレスに融合させることで、真空の安全性を次のレベルへと導きます。また、特別限定モデルのエグゼクティブ・エディションにのみ施されたゴールドのディテールにより、卓越したスタイリングとパフォーマンスのどちらかを選ぶ必要がなくなりました。	
item_Desc_rsi_explorer_light_armor_01_concierge_core	アイテムタイプライトアーマー\nダメージ軽減率：20\nキャリー容量：9K�SCU\n温度定格温度：-38 / 68\nバックパック互換性ライト\n\nロバート・スペース・インダストリーズのベンチャー・エクスプローラー・スーツは、新たなフロンティアを発見する時も、長い宇宙飛行の後に足を伸ばす時も、トップクラスの安全機能と驚異的な自由度をシームレスに融合させることで、真空の安全性を次のレベルへと導きます。また、特別限定モデルのエグゼクティブ・エディションにのみ施されたゴールドのディテールにより、卓越したスタイリングとパフォーマンスのどちらかを選ぶ必要がなくなりました。	
item_Desc_rsi_explorer_light_armor_01_concierge_legs	アイテムタイプライトアーマー\nダメージ軽減率：20\nキャリー容量：6K�SCU\n温度定格温度：-41 / 71\n\nロバート・スペース・インダストリーズのベンチャー・エクスプローラー・スーツは、新たなフロンティアを開拓する時も、長い宇宙飛行の後に足を伸ばす時も、トップクラスの安全機能と驚異的な自由度をシームレスに融合させることで、真空の安全性を次のレベルに引き上げます。また、特別限定モデルのエグゼクティブ・エディションにのみ施されたゴールドのディテールにより、卓越したスタイリングとパフォーマンスのどちらかを選ぶ必要がなくなりました。	
item_Desc_rsi_explorer_light_armor_01_helmet_ruso	アイテムタイプライトアーマー\nダメージ軽減率: 20%\n温度レート: -37 / 67 �C\n�\nRSIのベンチャーヘルメットは、耐衝撃性に優れたコンポジット製で、過酷な環境にも耐えられるように設計されています。また、アンチスカッフラミネートフェースプレートは、比類のない上方視界を提供し、どんな不思議なものを発見しても視界を妨げません。ラスト・ソサエティ・エディションは、レッドとタンの配色で、ハードな作業中にも見栄えがする。	
item_Desc_rsi_explorer_light_armor_01_ruso_arms	アイテムタイプライトアーマー\nダメージ軽減率: 20%\n温度レーティング: -37 / 67 �C\n\nRSIのVentureは未知の世界のために作られた軽量アーマーセットです。EVA規格のプロテクションシステムで、アンダースーツは耐久性に優れたポリマー製。ラスト・ソサエティ・エディションは赤とタンの配色で、ハードに働きながらも格好良く見える。	
item_Desc_rsi_explorer_light_armor_01_ruso_core	アイテムタイプライトアーマー\nダメージ軽減率：20\nキャリー容量：9K�SCU\n温度耐温度： -37 / 67\nバックパック互換性ライト\n\nRSIのベンチャーは未知の世界のために作られた軽量アーマーセットです。EVA規格のプロテクションシステムで、アンダースーツは耐久性に優れたポリマー製。ラスト・ソサエティ・エディションは赤とタンの配色で、ハードに働きながらも格好良く見える。	
item_Desc_rsi_explorer_light_armor_01_ruso_legs	アイテムタイプライトアーマー\nダメージ軽減率：20\nキャリー容量：6K�SCU\n温度定格温度：-40 / 70\n\nRSIのベンチャーは未知の世界のために作られた軽量アーマーセットです。このEVA規格のプロテクションシステムは、過酷な環境条件に耐える耐久性のあるポリマー織りのアンダースーツと、衝撃や微粒子から身を守るアーマーパーツで構成されています。ラスト・ソサエティ・エディションは赤とタンの配色で、ハードに働きながらも格好良く見える。	
item_Desc_rsi_explorer_light_arms_01_01_coramor	アイテムタイプライトアーマー\nダメージ軽減率: 20%\n温度レーティング: -38 / 68 �C\n\nロバート・スペース・インダストリーズのベンチャー・エクスプローラー・スーツは、宇宙の危険から身を守ります。次の冒険がどこに行くかわからない人のためにデザインされたこのスーツは、機動性を犠牲にすることなく、快適性と安全性を兼ね備えています。このLovestruckエディションは、Coramorフェスティバルの色にインスパイアされたスタイリッシュなメタリックピンクとブラックの配色が特徴です。	
item_Desc_rsi_explorer_light_arms_01_02_coramor	アイテムタイプライトアーマー\nダメージ軽減率: 20%\n温度レーティング: -38 / 68 �C\n\nロバート・スペース・インダストリーズのベンチャー・エクスプローラー・スーツは、宇宙の危険から身を守ります。次の冒険がどこに行くかわからない人のためにデザインされたこのスーツは、機動性を犠牲にすることなく、快適性と安全性を兼ね備えています。コラモール祭りにインスパイアされたエンヴィー・エディションは、ピンクとパープルの鮮やかな配色が特徴。	
item_Desc_rsi_explorer_light_arms_01_03_coramor	アイテムタイプライトアーマー\nダメージ軽減率: 20%\n温度レーティング: -38 / 68 �C\n\nロバート・スペース・インダストリーズのベンチャー・エクスプローラー・スーツは、宇宙の危険から身を守ります。次の冒険がどこに行くかわからない人のために設計されたこのスーツは、機動性を犠牲にすることなく快適さと安全性を兼ね備えています。この特別版「スタークロスド」は、25世紀の有名な映画「コラモール」でユーリ・イリインが着用していたアーマーをモデルにしています。	
item_Desc_rsi_explorer_light_core_01_01_coramor	アイテムタイプライトアーマー\nダメージ軽減率：20\nキャリー容量：9K�SCU\n温度定格温度：-38 / 68\nバックパック互換性ライト\n\nロバート・スペース・インダストリーズのベンチャー・エクスプローラー・スーツは、宇宙の危険から身を守ります。次の冒険がどこに行くかわからない人のためにデザインされたこのスーツは、機動性を犠牲にすることなく、快適性と安全性を兼ね備えています。このLovestruck特別版は、Coramorフェスティバルの色にインスパイアされたスタイリッシュなメタリックピンクと黒の配色が特徴です。	
item_Desc_rsi_explorer_light_core_01_02_coramor	アイテムタイプライトアーマー\nダメージ軽減率：20\nキャリー容量：9K�SCU\n温度定格温度：-38 / 68\nバックパック互換性ライト\n\nロバート・スペース・インダストリーズのベンチャー・エクスプローラー・スーツは、宇宙の危険から身を守ります。次の冒険がどこに行くかわからない人のためにデザインされたこのスーツは、機動性を犠牲にすることなく、快適性と安全性を兼ね備えています。Coramorフェスティバルにインスパイアされたこの特別なEnvyエディションは、最も熱狂的な愛好家のための鮮やかなピンクとパープルの配色が特徴です。	
item_Desc_rsi_explorer_light_core_01_03_coramor	アイテムタイプライトアーマー\nダメージ軽減率：20\nキャリー容量：9K�SCU\n温度定格温度：-38 / 68\nバックパック互換性ライト\n\nロバート・スペース・インダストリーズのベンチャー・エクスプローラー・スーツは、宇宙の危険から身を守ります。次の冒険がどこに行くかわからない人のためにデザインされたこのスーツは、機動性を犠牲にすることなく、快適性と安全性を兼ね備えています。このスタークロスド・エディションは、25世紀の有名な映画「コラモール」でユーリ・イリインが着用していたアーマーをモデルにしている。	
item_Desc_rsi_explorer_light_helmet_01	アイテムタイプライトアーマー\nダメージ軽減率: 20%\n温度レーティング: -38 / 68 �C\n\nRSIのVentureヘルメットは耐衝撃性に優れたコンポジット製で、過酷な環境にも耐えられるように設計されています。また、アンチスカッフラミネートフェースプレートを採用し、比類のない上方視界を提供する。	
item_Desc_rsi_explorer_light_helmet_01_01_centurion	アイテムタイプライトアーマー\nダメージ軽減率: 20%\n温度レーティング: -38 / 68 �C\n\nRSIのVentureヘルメットは耐衝撃性に優れたコンポジット製で、過酷な環境にも耐えられるように設計されています。また、アンチスカッフラミネートフェースプレートを採用し、比類のない上方視界を提供する。ボイジャー特別仕様のヘルメットは、レッドにブラックとホワイトのハイライトが入り、このスタイリッシュなスーツに理想的なカバーとなっている。	
item_Desc_rsi_explorer_light_helmet_01_01_imperator	アイテムタイプライトアーマー\nダメージ軽減率: 20%\n温度レーティング: -38 / 68 �C\n\nRSIのVentureヘルメットは耐衝撃性に優れたコンポジット製で、過酷な環境にも耐えられるように設計されています。また、アンチスカッフラミネートフェースプレートを採用し、比類のない上方視界を提供する。パスファインダー・エディションは、洗練されたベーススーツにマッチするゴールドのハイライトが入ったパープル。	
item_Desc_rsi_explorer_light_helmet_01_concierge	アイテムタイプライトアーマー\nダメージ軽減率: 20%\n温度レーティング: -38 / 68 �C\n\nRSIのVentureヘルメットは耐衝撃性に優れたコンポジット製で、過酷な環境にも耐えられるように設計されています。また、アンチスカッフラミネートフェースプレートを採用し、比類のない上方視界を提供。さらに、特別限定モデルのエグゼクティブ・エディションにのみ採用された、味わい深いゴールドのディテールにより、卓越したスタイリングと性能のどちらかを選ぶ必要がなくなりました。	
item_Desc_rsi_explorer_light_legs_01_01_coramor	アイテムタイプライトアーマー\nダメージ軽減率：20\nキャリー容量：6K�SCU\n温度定格温度：-41 / 71\n\nロバート・スペース・インダストリーズのベンチャー・エクスプローラー・スーツは、宇宙の危険から身を守ります。次の冒険がどこに行くかわからない人のためにデザインされたこのスーツは、機動性を犠牲にすることなく、快適性と安全性を兼ね備えています。このLovestruckエディションは、Coramorフェスティバルの色にインスパイアされたスタイリッシュなメタリックピンクとブラックの配色が特徴です。	
item_Desc_rsi_explorer_light_legs_01_02_coramor	アイテムタイプライトアーマー\nダメージ軽減率：20\nキャリー容量：6K�SCU\n温度定格温度：-41 / 71\n\nロバート・スペース・インダストリーズのベンチャー・エクスプローラー・スーツは、宇宙の危険から身を守ります。次の冒険がどこに行くかわからない人のためにデザインされたこのスーツは、機動性を犠牲にすることなく、快適性と安全性を兼ね備えています。コラモール祭りにインスパイアされたエンヴィーエディションは、ピンクとパープルの鮮やかなカラーリングが特徴。	
item_Desc_rsi_explorer_light_legs_01_03_coramor	アイテムタイプライトアーマー\nダメージ軽減率：20\nキャリー容量：6K�SCU\n温度定格温度：-41 / 71\n\nロバート・スペース・インダストリーズのベンチャー・エクスプローラー・スーツは、宇宙の危険から身を守ります。次の冒険がどこに行くかわからない人のために設計されたこのスーツは、機動性を犠牲にすることなく、快適さと安全性を兼ね備えています。このスタークロスド・エディションは、25世紀の有名な映画「コラモール」でユーリ・イリインが着用していたアーマーをモデルにしています。	
item_Desc_rsi_explorer_undersuit_01	アイテムタイプアンダースーツ\nダメージ軽減10%\n温度レーティング: -30 / 60 �C\n\nロバート・スペース・インダストリーズのベンチャー・エクスプローラー・スーツは、新たなフロンティアを開拓する時も、長い宇宙飛行の後に足を伸ばす時も、トップクラスの安全機能と驚異的な自由度をシームレスに融合させることで、真空の安全性を次のレベルに引き上げます。	
item_Desc_rsi_explorer_undersuit_01_01_coramor	アイテムタイプアンダースーツ\nダメージ軽減10%\n温度レーティング: -30 / 60 �C\n\nロバート・スペース・インダストリーズのベンチャー・エクスプローラー・スーツは、新たなフロンティアを開拓するにも、長時間の宇宙飛行の後に足を伸ばすにも、トップクラスの安全性と驚異的な動きやすさをシームレスに融合させた、真空の安全性を追求したスーツです。このLovestruckエディションは、Coramorフェスティバルの色にインスパイアされたスタイリッシュなメタリックピンクとブラックの配色が特徴です。	
item_Desc_rsi_explorer_undersuit_01_02_coramor	アイテムタイプアンダースーツ\nダメージ軽減10%\n温度レーティング: -30 / 60 �C\n\nロバート・スペース・インダストリーズのベンチャー・エクスプローラー・スーツは、新しいフロンティアを発見するときでも、長い宇宙飛行の後に足を伸ばすときでも、トップクラスの安全機能と驚異的な動きの自由をシームレスに融合させることで、真空の安全性を次のレベルに引き上げます。Coramorフェスティバルにインスパイアされたこの特別なEnvyエディションは、最も熱狂的な愛好家のための鮮やかなピンクとパープルの配色が特徴です。	
item_Desc_rsi_explorer_undersuit_01_03_coramor	アイテムタイプアンダースーツ\nダメージ軽減10%\n温度レーティング: -30 / 60 �C\n\nロバート・スペース・インダストリーズのベンチャー・エクスプローラー・スーツは、新たなフロンティアを開拓するにも、長時間の宇宙飛行の後に足を伸ばすにも、トップクラスの安全機能と驚異的な自由度をシームレスに融合させ、真空の安全性を次のレベルに引き上げます。この特別版「スタークロスド」は、25世紀の有名な映画「コラモール」でユーリ・イリインが着用していたアーマーをモデルにしており、同名の恋人たちの祭典のインスピレーションとなっている。	
item_Desc_rsi_explorer_undersuit_01_concierge	アイテムタイプアンダースーツ\nダメージ軽減10%\n温度レーティング: -30 / 60 �C\n\nロバート・スペース・インダストリーズのベンチャー・エクスプローラー・スーツは、新たなフロンティアを開拓する時も、長時間の宇宙飛行の後に足を伸ばす時も、トップクラスの安全機能と驚異的な自由度をシームレスに融合させることで、真空の安全性を次のレベルに引き上げます。この特別なエグゼクティブ・エディションは、ダイナミックなブラックとゴールドのカラーパレットが特徴です。	
item_Desc_rsi_explorer_undersuit_01_ruso	アイテムタイプアンダースーツ\nダメージ軽減10%\n温度レーティング: -30 / 60 �C\n\nロバート・スペース・インダストリーズのベンチャー・エクスプローラー・スーツは、新たなフロンティアを開拓する時も、長い宇宙飛行の後に足を伸ばす時も、トップクラスの安全機能と驚異的な自由度をシームレスに融合させることで、真空の安全性を次のレベルに引き上げます。ラスト・ソサエティ・エディションは、赤とタンの配色で、ハードに働きながらも格好良く見えます。	
item_Desc_rsi_light_utility_backpack_01	アイテムタイプ軽量バックパック\n容量： 50K �SCU\nコアの互換性すべて\n\nMacFlex Backpackは、背面にハードシェルケースを装着することで、より多くの物資を収納することができます。長期の遠征で余分な物資を持ち運ぶ際にも、採掘に成功した後に鉱石を詰め込む際にも、MacFlex Backpackが荷物を運んでくれます。	
item_Desc_rsi_odyssey_caudillo_helmet_01_01_01	アイテムタイプヘビーアーマー\nダメージ軽減40%\n温度レーティング: -30 / 60 �C\n\n大気圏内や宇宙空間での銃撃戦に耐えるコーディロヘルメットは、頭部をしっかりと保護しながらも、金属製の紋章が印象的なクラシカルなアーマーのようなスタイリッシュな外観を備えています。コバルトは限定生産です。	
item_Desc_rsi_odyssey_caudillo_helmet_01_01_02	アイテムタイプヘビーアーマー\nダメージ軽減40%\n温度レーティング: -30 / 60 �C\n\n大気圏内や宇宙空間での銃撃戦に耐えるコーディロ・ヘルメットは、頭部をしっかりと保護する一方で、金属製の紋章が印象的なクラシカルなアーマーのようなスタイリッシュな外観を備えています。ワイルドファイアは限定生産です。	
item_Desc_rsi_odyssey_caudillo_helmet_01_01_03	アイテムタイプヘビーアーマー\nダメージ軽減40%\n温度レーティング: -30 / 60 �C\n\n大気圏内や宇宙空間での銃撃戦に耐えるコーディロヘルメットは、頭部をしっかりと保護しながら、金属製の紋章が印象的なクラシカルなアーマーのようなスタイリッシュな外観を備えています。バーントオレンジは限定生産です。	
item_Desc_rsi_odyssey_caudillo_helmet_01_01_04	アイテムタイプヘビーアーマー\nダメージ軽減40%\n温度レーティング: -30 / 60 �C\n\n大気圏内や宇宙空間での銃撃戦に耐えるコーディロヘルメットは、頭部をしっかりと保護しながら、金属製の紋章が印象的なクラシカルなアーマーのようなスタイリッシュな外観を備えています。ハザードは限定生産。	
item_Desc_rsi_odyssey_caudillo_helmet_01_01_10	アイテムタイプヘビーアーマー\nダメージ軽減40%\n温度レーティング: -30 / 60 �C\n\n大気圏内や宇宙空間での銃撃戦に耐えるコーディロヘルメットは、頭部をしっかりと保護しながらも、印象的なメタルクレストにより、クラシカルなアーマーのようなスタイリッシュな外観を備えています。ゴーストホワイトは限定生産です。	
item_Desc_rsi_odyssey_caudillo_helmet_01_01_11	アイテムタイプヘビーアーマー\nダメージ軽減40%\n温度レーティング: -30 / 60 �C\n\n大気圏内や宇宙空間での銃撃戦に耐えるコーディロ・ヘルメットは、頭部をしっかりと保護すると同時に、金属製の紋章が印象的なクラシカルなアーマーのようなスタイリッシュな外観を備えています。スチール製は限定生産です。	
item_Desc_rsi_odyssey_caudillo_helmet_01_01_9tails01	アイテムタイプヘビーアーマー\nダメージ軽減40%\n温度レーティング: -30 / 60 �C\n\nCC's ConversionsのCaudilloヘルメットを原型から改良したバージョン。大気圏内や宇宙空間での銃撃戦に耐え、頭部をしっかりと保護しながらも、金属製の紋章が印象的なクラシカルなアーマーのようなスタイリッシュな外観を備えています。	
item_Desc_rsi_odyssey_undersuit_01_Shared	アイテムタイプアンダースーツ\nダメージ軽減10%\n温度レーティング: -30 / 60 �C\n\nRSIのクラシックアンダースーツOdysseyの最新世代は、宇宙や惑星での過酷な環境にも耐えうる頑丈なデザインが特徴。最新のマイクロウィーブテクノロジーを採用したOdyssey IIアンダースーツは、快適とは言い難い環境下でも何時間もの快適性を提供します。	
item_Desc_rsi_odyssey_undersuit_helmet_01_01_coramor	アイテムタイプフライト・ヘルメット\nダメージ軽減10%\n温度レーティング: -30 / 60 �C\n\n頑丈で信頼性の高いRSIヘルメットの伝統を継承するOdyssey IIは、耐久性を犠牲にすることなく、オリジナルデザインをより軽量なフレームにスリム化。様々なコンディションや環境下でのフィールドテストを繰り返し、安全性を高めている。このLovestruckエディションは、Coramorフェスティバルのカラーにインスパイアされた、スタイリッシュなメタリックピンクとブラックの配色が特徴。	
item_Desc_rsi_odyssey_undersuit_helmet_01_01_opaque	アイテムタイプフライト・ヘルメット\nダメージ軽減10%\n温度レーティング: -30 / 60 �C\n\n頑丈で信頼性の高いRSIヘルメットの伝統を継承するOdyssey IIは、耐久性を犠牲にすることなく、オリジナルデザインをより軽量なフレームにスリム化。様々なコンディションや環境下でのフィールドテストを繰り返し、安全性を高めている。この特別なオブシディアンバリアントは、匿名性を保ちたい人のために、バイザーを暗くしている。	
item_Desc_rsi_odyssey_undersuit_helmet_01_02_coramor	アイテムタイプフライト・ヘルメット\nダメージ軽減10%\n温度レーティング: -30 / 60 �C\n\n頑丈で信頼性の高いRSIヘルメットの伝統を継承するOdyssey IIは、耐久性を犠牲にすることなく、オリジナルデザインをより軽量なフレームにスリム化。様々なコンディションや環境下でのフィールドテストを繰り返し、安全性を追求した多目的ヘルメット。Coramorフェスティバルにインスパイアされたこの特別なEnvyエディションは、熱狂的な愛好家のために鮮やかなピンクとパープルの配色が施されている。	
item_Desc_rsi_odyssey_undersuit_helmet_01_03_coramor	アイテムタイプフライト・ヘルメット\nダメージ軽減10%\n温度レーティング: -30 / 60 �C\n\n頑丈で信頼性の高いRSIヘルメットの伝統を継承するOdyssey IIは、耐久性を犠牲にすることなく、オリジナルデザインをより軽量なフレームにスリム化。様々なコンディションや環境下でのフィールドテストを繰り返し、安全性を高めている。このスタークロスド・エディションは、25世紀の有名な映画『コラモール』でユーリ・イリインが着用していたアーマーをモデルにしており、同名の恋人たちの祭典にインスピレーションを与えた。	
item_Desc_rsi_odyssey_undersuit_helmet_01_Shared	アイテムタイプフライト・ヘルメット\nダメージ軽減10%\n温度レーティング: -30 / 60 �C\n\n頑丈で信頼性の高いRSIヘルメットの伝統を継承するOdyssey IIは、耐久性を犠牲にすることなく、オリジナルデザインをより軽量なフレームにスリム化。様々なコンディションや環境下でのフィールドテストを繰り返し、安全性を追求した多目的ヘルメット。	
item_Desc_rsi_pilot_flightsuit_helmet_01	アイテムタイプフライト・ヘルメット\nダメージ軽減10%\n温度レーティング: -30 / 60 �C\n\nRSIのOdysseyヘルメットは非常に軽量で邪魔にならず、被っていることを忘れるほど。耐衝撃性に優れたカーボンファイバー製で、衝撃を吸収するフォームがインサートされている。	
item_Desc_rsi_utility_heavy_helmet_01_01_01	アイテムタイプヘビー・ヘルメット\nダメージ軽減40%\n温度レーティング: -150 / 175 �C\n\nゼウス・エクスプロレーション・スーツは、最初の商業宇宙船であるゼウスを開発しテストしたRSIクルー、初期の宇宙開拓者に敬意を表してデザインされた。このスーツは、ヘルメットとバックパック用のアタッチメントを備えた何世紀も前のものと同じスタイルですが、現代の探検家に期待される現代的なテクノロジーと利便性をすべて備えています。ゼウスは過酷な環境にも耐えることができ、EVA時のサンプル採取のための収納スペースも充実している。このヘルメットはゼウス探査スーツにのみ適合します。	
item_Desc_rsi_utility_heavy_helmet_01_01_03	アイテムタイプヘビー・ヘルメット\nダメージ軽減40%\n温度レーティング: -150 / 175 �C\n\nゼウス・エクスプロレーション・スーツは、最初の商業宇宙船であるゼウスを開発しテストしたRSIクルー、初期の宇宙開拓者に敬意を表してデザインされた。このスーツは、ヘルメットとバックパック用のアタッチメントを備えた何世紀も前のものと同じスタイルですが、現代の探検家に期待される現代的なテクノロジーと利便性をすべて備えています。ゼウスは過酷な環境にも耐えることができ、EVA時のサンプル採取のための収納スペースも充実している。このヘルメットはゼウス探査スーツにのみ適合します。ソーラーバージョンは、RSIテストパイロットが着用したオレンジの配色に敬意を表しています。	
item_Desc_rsi_utility_heavy_helmet_01_01_12	アイテムタイプヘビー・ヘルメット\nダメージ軽減40%\n温度レーティング: -150 / 175 �C\n\nゼウス・エクスプロレーション・スーツは、最初の商業宇宙船であるゼウスを開発しテストしたRSIクルー、初期の宇宙開拓者に敬意を表してデザインされた。このスーツは、ヘルメットとバックパック用のアタッチメントを備えた何世紀も前のものと同じスタイルですが、現代の探検家に期待される現代的なテクノロジーと利便性をすべて備えています。ゼウスは過酷な環境にも耐えることができ、EVA時のサンプル採取のための収納スペースも充実している。このヘルメットはゼウス探査スーツにのみ適合します。スタースケープのバリエーションは、RSIのエンジニアが着用するブラックのカラースキームに敬意を表しています。	
item_Desc_rsi_utility_heavy_suit_01_01_01	アイテムタイプヘビーアーマー\nダメージ軽減40%\n持ち運び可能量: 8K SP\n温度レーティング： -150 / 175 �C\nバックパック互換性：すべて\n\nゼウス・エクスプロレーション・スーツは、最初の商業宇宙船であるゼウスを開発しテストしたRSIクルー、初期の宇宙開拓者に敬意を表してデザインされました。このスーツは、ヘルメットとバックパック用のアタッチメントを備えた何世紀も前のものと同じスタイルですが、現代の探検家に期待される現代的なテクノロジーと利便性をすべて備えています。ゼウスは過酷な環境への耐性に優れ、船外活動中のサンプル採取のための優れた収納スペースを備えている。	
item_Desc_rsi_utility_heavy_suit_01_01_03	アイテムタイプヘビーアーマー\nダメージ軽減40%\n持ち運び可能量: 8K SP\n温度レーティング： -150 / 175 �C\nバックパック互換性：すべて\n\nゼウス・エクスプロレーション・スーツは、最初の商業宇宙船であるゼウスを開発しテストしたRSIクルー、初期の宇宙開拓者に敬意を表してデザインされました。このスーツは、ヘルメットとバックパック用のアタッチメントを備えた何世紀も前のものと同じスタイルですが、現代の探検家に期待される現代的なテクノロジーと利便性をすべて備えています。ゼウスは過酷な環境への耐性に優れ、船外活動中のサンプル採取のための優れた収納スペースを備えている。ソーラー・タイプは、RSIのテストパイロットが着用していたオレンジのカラースキームに敬意を表しています。	
item_Desc_rsi_utility_heavy_suit_01_01_12	アイテムタイプヘビーアーマー\nダメージ軽減40%\n持ち運び可能量: 8K SP\n温度レーティング： -150 / 175 �C\nバックパック互換性：すべて\n\nゼウス・エクスプロレーション・スーツは、最初の商業宇宙船であるゼウスを開発しテストしたRSIクルー、初期の宇宙開拓者に敬意を表してデザインされました。このスーツは、ヘルメットとバックパック用のアタッチメントを備えた何世紀も前のものと同じスタイルですが、現代の探検家に期待される現代的なテクノロジーと利便性をすべて備えています。ゼウスは過酷な環境への耐性に優れ、EVA時のサンプル採取のための優れた収納スペースを備えている。スタースケープのバリエーションは、RSIのエンジニアが着用するブラックのカラースキームに敬意を表しています。	
item_Desc_sasu_armor_light_helmet_01_01_9tails01	アイテムタイプライトアーマー\nダメージ軽減率: 20%\n温度レーティング: -35 / 65 �C\n\nサクラサンのマンディブルヘルメットを改良したバージョン。サクラサン独自のマンディブルヘルメットで、"バグ・アウト "の準備が整っていることを示そう。軽量なメッキ加工が施され、金属製の牙が前面から突き出ています。	
item_Desc_sasu_combat_heavy_helmet_01	アイテムタイプヘビーアーマー\nダメージ軽減40%\n温度レーティング: -90 / 115 �C\n\nヴォイドリッパー・ヘルメットを装備することで、内なる獣を受け入れよう。重厚な装甲メッキが幾重にも施されたこのヘルメットは、重々しい眉と鋭いターコイズブルーの瞳が印象的な、忘れがたいビジュアルを備えています。サクラサンのデザイナーは、この印象的なフォルムに、ヘルメットの右側に取り付けられた最新鋭のセンサー群など、最高の機能を付加しました。	
item_Desc_sasu_combat_heavy_helmet_01_01_9tails01	アイテムタイプヘビーアーマー\nダメージ軽減40%\n温度レーティング: -90 / 115 �C\n\nサクラサンのヴォイドリッパーヘルメットをオリジナルから改良したバージョン。ヴォイドリッパーヘルメットを装備することで、あなたの内なる獣を受け入れることができます。重厚なアーマーメッキがプレミアムなプロテクションを提供します。サクラサンのデザイナーは、ヘルメットの右側に最新のセンサーを搭載するなど、この印象的なフォルムに最高の機能を持たせました。	
item_Desc_sasu_light_armor_helmet_01	アイテムタイプライトアーマー\nダメージ軽減率: 20%\n温度レーティング: -35 / 65 �C\n\nサクラサンの限定ヘルメット、マンディブル。軽量のメッキ加工が施され、前面には金属の牙が突き出ている。	
item_Desc_sasu_medium_armor_helmet_01_01_01	アイテムタイプミディアム・アーマー\nダメージ軽減30%\n温度レーティング: -63 / 93 �C\n\nサクラサンの記念ヘルメットで、GENADY KUZOの名作アニメ「スターキトン」をお祝いしよう。この中型ヘルメットのカスタム成型は、防御力を犠牲にすることなく、番組の象徴的なキャラクターデザインを忠実に再現している。内蔵されたアクセントライトは、ヘルメットのユニークなシルエットを際立たせ、ポップな色彩を提供する。ピンクのスター子猫ヘルメットは、番組ファンや珍しいアーマー愛好家の間でコレクターズアイテムとなることは間違いない。	
item_Desc_sasu_medium_armor_helmet_01_01_10	アイテムタイプミディアム・アーマー\nダメージ軽減30%\n温度レーティング: -63 / 93 �C\n\nサクラサンの記念ヘルメットで、GENADY KUZOの名作アニメ「スターキトン」をお祝いしよう。この中型ヘルメットのカスタム成型は、防御力を犠牲にすることなく、番組の象徴的なキャラクターデザインを忠実に再現している。内蔵されたアクセントライトがポップな色彩を与え、ヘルメットのユニークなシルエットを際立たせる。このヘルメットは、番組のファンや珍しいアーマー愛好家の間でコレクターズアイテムとなるに違いない。スターにゃんこサリーエディションは、お調子者の主人公をイメージしたホワイト。	
item_Desc_sasu_medium_armor_helmet_01_01_19	アイテムタイプミディアム・アーマー\nダメージ軽減30%\n温度レーティング: -63 / 93 �C\n\nサクラサンの記念ヘルメットで、GENADY KUZOの名作アニメ「スターキトン」をお祝いしよう。この中型ヘルメットのカスタム成型は、防御力を犠牲にすることなく、番組の象徴的なキャラクターデザインを忠実に再現している。内蔵されたアクセントライトがポップな色彩を与え、ヘルメットのユニークなシルエットを際立たせる。このヘルメットは、番組のファンや珍しいアーマー愛好家の間でコレクターズアイテムとなることは間違いない。黒を基調としたスター子猫デイモン版は、サリーの親友であり、いたずら好きな冒険に参加するよう常に誘惑してくるデイモンをイメージしている。	
item_Desc_scu_pants_04	キャリング容量：2K µSCU\n\nワークウェアの不屈の精神とカーキの快適さを併せ持つCaretパンツは、タフな仕事の定番になること間違いなし。丈夫な生地と上質な縫製で、やるべきことに集中できる。	
item_Desc_slaver_armor_heavy_arms_01	アイテムタイプヘビーアーマー\nダメージ軽減40%\n温度レーティング: -72 / 102 �C\n\nクラーク・ディフェンス・システムズは、UEE海兵隊が信頼する製造ノウハウと専門知識を取り入れ、3つ星に格付けされた保護メッキと完全に統合された機動性フレームワークにより、最も過酷な戦闘シナリオに直面しても堅固に立ち向かえるよう、民間ラインのディファイアンス・ヘビーアーマーを設計しました。	
item_Desc_slaver_armor_heavy_arms_01_01_9tails01	アイテムタイプヘビーアーマー\nダメージ軽減40%\n温度レーティング: -72 / 102 �C\n\nこのバージョンは、CDSのディファイアンス・アームズの原型から改良されたものである。クラーク・ディフェンス・システムズは、UEE海兵隊が信頼する製造ノウハウと専門知識を取り入れ、3つ星に格付けされた保護メッキと完全に統合された機動性フレームワークにより、最も過酷な戦闘シナリオに直面しても堅固に立ち向かえるよう、民間ラインのディファイアンス・ヘビーアーマーを設計した。	
item_Desc_slaver_armor_heavy_core_01	アイテムタイプヘビーアーマー\nダメージ軽減40%\nキャリー容量：10.5k�SCU\n温度定格温度: -72 / 102 °C\nバックパックとの互換性すべて\n\nクラーク・ディフェンス・システムズは、UEE海兵隊が信頼する製造ノウハウと専門知識を取り入れ、3つ星に格付けされた保護メッキと完全に統合された可動フレームワークにより、最も過酷な戦闘シナリオに直面しても堅固に立ち向かえるよう、民間ラインのディファイアンス・ヘビーアーマーを設計しました。	
item_Desc_slaver_armor_heavy_core_01_01_9tails01	アイテムタイプヘビーアーマー\nダメージ軽減40%\nキャリー容量：10.5k�SCU\n温度定格温度：-72 / 102\nバックパックとの互換性すべて\n\nCDSのDefianceコアをオリジナルから改良したバージョン。クラーク・ディフェンス・システムズは、UEE海兵隊が信頼する製造ノウハウと専門知識を取り入れ、3つ星に格付けされた保護メッキと完全に統合された可動フレームワークにより、最も過酷な戦闘シナリオに直面しても堅固に立ち向かえるよう、民間ラインのディファイアンス・ヘビーアーマーを設計しました。	
item_Desc_slaver_armor_heavy_helmet_01	アイテムタイプヘビーアーマー\nダメージ軽減40%\n温度レーティング: -72 / 102 �C\n\nDefianceは、アーマープレーティングの下に2層のコンポジットウィーブで構成された完全密閉型のバトルヘルメットで、貫通攻撃や脳震盪攻撃に対して最大限のプロテクションを提供します。	
item_Desc_slaver_armor_heavy_helmet_01_01_9tails01	アイテムタイプヘビーアーマー\nダメージ軽減40%\n温度レーティング: -72 / 102 �C\n\nCDSのDefianceヘルメットをオリジナルから改良したバージョン。ディファイアンスヘルメットは、アーマーメッキの下に2層のコンポジットウィーブが施された完全密閉型のバトルヘルメットで、貫通攻撃や脳震盪攻撃に対して最大限のプロテクションを提供します。	
item_Desc_slaver_armor_heavy_legs_01	アイテムタイプヘビーアーマー\nダメージ軽減40%\nキャリー容量：6.5k�SCU\n温度定格温度: -72 / 102 °C\n\nクラーク・ディフェンス・システムズは、UEE海兵隊が信頼する製造ノウハウと専門知識を取り入れ、3つ星に格付けされた保護メッキと完全に統合された機動性フレームワークにより、最も過酷な戦闘シナリオに直面しても堅固に立ち向かえるよう、民間ラインのディファイアンス・ヘビーアーマーを設計しました。	
item_Desc_slaver_armor_heavy_legs_01_01_9tails01	アイテムタイプヘビーアーマー\nダメージ軽減40%\nキャリー容量：6.5k�SCU\n温度定格温度: -72 / 102 °C\n\nCDSのディファイアンス・レッグに改良を加えたバージョン。クラーク・ディフェンス・システムズは、UEE海兵隊が信頼する製造ノウハウと専門知識を取り入れ、3つ星に格付けされた保護メッキと完全に統合された機動フレームワークにより、最も過酷な戦闘シナリオにも耐える民間ラインのディファイアンス・ヘビーアーマーを設計した。	
item_Desc_slaver_armor_light_legs_01_01_9tails01	アイテムタイプライトアーマー\nダメージ軽減率：20\nキャリー容量：2.5K �SCU\n温度定格温度：-39 / 69\n\nカスタークアームズのキャリコレッグに改良を加えたバージョン。EVA準拠のライトコンバットスーツとして設計されたキャリコセットは、潜入者、スナイパー、泥棒など、基本的にドアを蹴破りたくない人に最適なアーマースーツです。PAB3アーマーとカスタムヘルメットの組み合わせで作られたこのアーマースーツは、あなたの動きを鈍らせることなく、飛んでくる砲火をやり過ごすことができる。	
item_Desc_slaver_light_armor_01_Shared	アイテムタイプライトアーマー\nダメージ軽減率: 20%\n温度レーティング: -39 / 69 �C\n\nEVA準拠のライトコンバットスーツとして設計されたキャリコセットは、潜入者、スナイパー、泥棒など、基本的にドアを蹴破りたくない人に最適なアーマースーツです。PAB3アーマーとカスタムヘルメットの組み合わせで作られており、足手まといになることなく着弾をやり過ごすことができる。	
item_Desc_slaver_light_armor_01_core	アイテムタイプライトアーマー\nダメージ軽減率：20\n携帯能力：4K�SCU\n温度耐温度： -39 / 69\nバックパック互換性ライト\n\nEVA準拠のライトコンバットスーツとして設計されたキャリコセットは、潜入者、スナイパー、泥棒など、基本的にドアを蹴破りたくない人に最適なアーマースーツです。PAB3アーマーとカスタムヘルメットの組み合わせで作られており、あなたの動きを鈍らせることなく、襲い来る銃撃をやり過ごすことができる。	
item_Desc_slaver_light_armor_01_legs	アイテムタイプライトアーマー\nダメージ軽減率：20\nキャリー容量：2.5K �SCU\n温度定格温度：-39 / 69\n\nEVA準拠のライトコンバットスーツとして設計されたキャリコセットは、潜入者、スナイパー、泥棒など、基本的にドアを蹴破りたくない人に最適なアーマースーツです。PAB3アーマーとカスタムヘルメットの組み合わせで作られており、足手まといになることなく着弾をやり過ごすことができる。	
item_Desc_slaver_light_armor_helmet_02	アイテムタイプライトアーマー\nダメージ軽減率: 20%\n温度レーティング: -39 / 69 �C\n\nKastak ArmのRenegadeコンバットヘルメットは、軽量かつ耐久性に優れた歩兵用ヘルメットです。	
item_Desc_slaver_medium_armor_01_Shared	アイテムタイプミディアム・アーマー\nダメージ軽減30%\n温度レーティング: -60 / 90 �C\n\nDustUpは、トラブルに巻き込まれた際にあなたの背中をサポートします。ボディはUEE海兵隊が使用するCDSアンダースーツから作られており、オムニロールmkIIを再構築したパーツが着弾から身を守ってくれる。このヘルメットは爆発に耐えられるように作られているので、多少の銃撃なら完全に防いでくれるはずだ。ヘルメット全体は真空に対するテストもそこそこ行われているので、死ぬ心配をすることなく、好きなだけ船外活動をすることができる。	
item_Desc_slaver_medium_armor_01_arms	アイテムタイプミディアム・アーマー\nダメージ軽減30%\n温度レーティング: -60 / 90 �C\n\nDustUpは、トラブルに巻き込まれた際にあなたの背中をサポートします。ボディはUEE海兵隊が使用するCDSアンダースーツから作られており、オムニロールmkIIを再構築したパーツが着弾から身を守ってくれる。このヘルメットは爆発に耐えられるように作られているので、多少の銃撃なら完全に防いでくれるはずだ。ヘルメット全体は真空に対するテストもそこそこ行われているので、死ぬ心配をすることなく、好きなだけ船外活動をすることができる。	
item_Desc_slaver_medium_armor_01_core	アイテムタイプミディアム・アーマー\nダメージ軽減30%\nキャリー容量：7.5k�SCU\n温度定格温度：-60 / 90\nバックパックとの互換性ライト	
item_Desc_slaver_medium_armor_01_legs	アイテムタイプミディアム・アーマー\nダメージ軽減30%\nキャリー容量：4.5K�SCU\n温度定格温度：-60 / 90\n\nDustUpは、トラブルに巻き込まれた際にあなたの背中をサポートします。ボディはUEE海兵隊で使用されているCDSアンダースーツから作られており、オムニロールmkIIを再構築したパーツを追加することで、襲い来る砲火から身を守る。このヘルメットは爆発に耐えられるように作られているので、多少の銃撃なら完全に防いでくれるはずだ。ヘルメット全体は真空に対するテストもそこそこ行われているので、死ぬ心配をすることなく、好きなだけ船外活動をすることができる。	
item_Desc_slaver_medium_armor_helmet_01_starkitty	アイテムタイプミディアム・アーマー\nダメージ軽減30%\n\nKastak ArmsのクラシックなDustUpヘルメットの記念モデル。このミディアムヘルメットのディフェンス能力を犠牲にすることなく、見事なシルエットを作り出すライティングが埋め込まれている。	
item_Desc_slaver_undersuit_armor_01_01_01	アイテムタイプアンダースーツ\nダメージ軽減10%\n温度レーティング: -30 / 60 �C\n\nKastak ArmsのStoneskinは、CDSの有名なTCS-4システムをベースに作られたコンバットアンダースーツです。アーマーやEVAのオプションが豊富で、CDSに匹敵する頑丈で信頼性の高いアンダースーツです。	
item_Desc_srvl_heavy_armor_01_Shared	アイテムタイプヘビーアーマー\nダメージ軽減40%\n温度レーティング: -77 / 107 �C\n\nオーバーロードを英雄視する者もいれば、犯罪者視する者もいる。ドゥームズデイはどっちでもいい。我々が知っているのは、パイロで無法者を標的にしたことで名を馳せた自警団が、キレッキレで個性的で弾力性のあるアーマーを持っているということだけだ。我々も彼らと同様に法の支配を尊重しているので、彼らにインスパイアされたアーマーを限定生産した。もし彼らに文句があるなら、僕らを探しに来ればいい。  \n\nオーバーロードアーマーは、敵にあなたの本気を知らしめる。このヘビーアーマーセットは、衝撃の力を分散させるために戦略的に配置された耐久性の高い複合メッキと、首と後頭部をさらに保護する高い補強襟で構成されている。スーツはまた、安全性を犠牲にすることなく瞬間の容易さを確保するために、関節の周りに高強度合成繊維で層状になっています。オーバーロードは、（中略）有名な派閥のメンバーが着用する数種類のカラーが用意されている。パイロに所属している間は、トラブルを避けたいのでなければ着用しないほうがいいだろう。警告しなかったとは言わせない！	
item_Desc_srvl_heavy_armor_01_legs	アイテムタイプヘビーアーマー\nダメージ軽減40%\nキャリー容量：7.5k�SCU\n温度定格温度: -77 / 107 °C\n\nオーバーロードを英雄視する者もいれば、犯罪者視する者もいる。ドゥームズデイはそのどちらでも構わない。我々が知っているのは、パイロで無法者を標的にしたことで名を馳せた自警団が、キレッキレで個性的で弾力性のあるアーマーを持っているということだけだ。我々も彼らと同様に法の支配を尊重しているので、彼らにインスパイアされたアーマーを限定生産した。もし彼らに文句があるなら、僕らを探しに来ればいい。  \n\nオーバーロードアーマーは、敵にあなたの本気を知らしめる。このヘビーアーマーセットは、衝撃の力を分散させるために戦略的に配置された耐久性の高い複合メッキと、首と後頭部をさらに保護する高い補強襟で構成されている。スーツはまた、安全性を犠牲にすることなく瞬間の容易さを確保するために、関節の周りに高強度合成繊維で層状になっています。オーバーロードは、（中略）有名な派閥のメンバーが着用する数種類のカラーが用意されている。パイロに所属している間は、トラブルを避けたいのでなければ着用しないほうがいいだろう。警告しなかったとは言わせない！	
item_Desc_srvl_heavy_core_01	アイテムタイプヘビーアーマー\nダメージ軽減40%\nキャリー容量：12k�SCU\n温度レーティング： -77 / 107 �C\nバックパックとの互換性すべて\n\nオーバーロードを英雄視する者もいれば、犯罪者視する者もいる。ドゥームズデイはどっちでもいいと思っている。我々が知っているのは、Pyroで無法者を標的にしたことで名を馳せた自警団グループが、キレキレで個性的で弾力性のあるアーマーを持っているということだけだ。我々も彼らと同様に法の支配を尊重しているので、彼らにインスパイアされたアーマーを限定生産した。もし彼らに文句があるなら、僕らを探しに来ればいい。  \n\nオーバーロードアーマーは、敵にあなたの本気を知らしめる。このヘビーアーマーセットは、衝撃の力を分散させるために戦略的に配置された耐久性の高い複合メッキと、首と後頭部をさらに保護する高い補強襟で構成されている。スーツはまた、安全性を犠牲にすることなく瞬間の容易さを確保するために、関節の周りに高強度合成繊維で層状になっています。オーバーロードは、（中略）有名な派閥のメンバーが着用する数種類のカラーが用意されている。パイロに所属している間は、トラブルを避けたいのでなければ着用しないほうがいいだろう。警告しなかったとは言わせない！	
item_Desc_srvl_heavy_helmet_01	アイテムタイプヘビーアーマー\nダメージ軽減40%\n温度レーティング: -77 / 107 �C\n\n頭部に大きな重さを感じることなく、完全な保護と匿名性を維持。Overlordヘルメットは重い装甲を保護しながらも、特殊な軽量複合メッキを使用しているため、まるで何もないかのように感じられます。また、オーバーロード・スーツを着用した場合、ハイネックカラーがヘルメットのサポートとプロテクションを強化する。	
item_Desc_srvl_jacket_01_01_01	古いダスターズの旗、引き揚げられた鎧、廃船の部品で組み立てられたこのジャケットは、頑丈な革ひもで着用者に固定されている。	
item_Desc_srvl_jacket_02	このジャケットは、カルデラアーマーセットのパーツを再利用して作られたもので、過酷な環境下で着用者をさらに保護する。	
item_Desc_srvl_pants_01_01_01	このパンツは良い日が続いたかもしれないが、まだまだ寿命はある。長年の使用により、購入時よりも履き心地が良くなっている。	
item_Desc_srvl_shirt_01_01_01	メーカー不明のこのシャツは、第二の人生を歩むために繕われ、仕立て直された。右袖の半分が修復不可能だったため、残りはエルボーカフになった。	
item_Desc_srvl_undersuit_01	アイテムタイプアンダースーツ\nダメージ軽減10%\n温度レーティング: -30 / 60 �C\n\nWhy Notヘルメットと同じ比較的信頼性の高い構造のSecond Lifeは、ボロボロになった古いアンダースーツに新しい命を吹き込む。	
item_Desc_srvl_undersuit_helmet_01	アイテムタイプフライト・ヘルメット\nダメージ軽減10%\n温度レーティング: -30 / 60 �C\n\nヘルメットが壊れたからといって役に立たないわけではない。このアンダースーツ用ヘルメットは、真空から身を守るのに適している。チャンスに賭けるのが好きなら、これに賭けてみよう。なぜダメなのか？	
item_Desc_syfb_flightsuit_helmet_01_01_01	アイテムタイプフライト・ヘルメット\nダメージ軽減15%\n温度レーティング: -30 / 60 �C\n\nSyang Fabricationが人間の体格に合うように改良したXanthuleヘルメットは、西安が好んだ大胆なシルエットを忠実に再現している。ザンスールスーツと組み合わせることで、個性的で人目を引くルックスとなる。	
item_Desc_syfb_flightsuit_helmet_01_01_02	アイテムタイプフライト・ヘルメット\nダメージ軽減15%\n温度レーティング: -30 / 60 �C\n\nSyang Fabricationが人間の体格に合うように改良したXanthuleヘルメットは、西安が好んだ大胆なシルエットを忠実に再現している。ザンスールスーツと組み合わせることで、個性的で人目を引くルックスとなる。	
item_Desc_syfb_flightsuit_helmet_01_01_07	アイテムタイプフライト・ヘルメット\nダメージ軽減15%\n温度レーティング: -30 / 60 �C\n\nSyang Fabricationが人間の体格に合うように改良したXanthuleヘルメットは、西安が好んだ大胆なシルエットを忠実に再現している。ザンスールスーツと組み合わせることで、個性的で人目を引くルックスとなる。	
item_Desc_syfb_flightsuit_suit_01_01_01	アイテムタイプフライトスーツ\nダメージ軽減15%\n温度レーティング: -30 / 60 �C\n\n何世紀にもわたる技術革新により完成した、Syang Fabricationの洗練されたスタイリッシュなザンスールフライトスーツは、人間の体格に合わせ細心の注意を払って作られています。通気性に優れたカーボンシルク織りの軽量メッキを採用し、信頼性の高いプロテクションを提供しながら、メゾンの特徴である美的感覚を損なわない。	
item_Desc_syfb_flightsuit_suit_01_01_02	アイテムタイプフライトスーツ\nダメージ軽減15%\n温度レーティング: -30 / 60 �C\n\n何世紀にもわたる技術革新により完成した、Syang Fabricationの洗練されたスタイリッシュなザンスールフライトスーツは、人間の体格に合わせ細心の注意を払って作られています。通気性に優れたカーボンシルク織りの軽量メッキを採用し、信頼性の高いプロテクションを提供しながら、メゾンの特徴である美的感覚を損なわない。	
item_Desc_syfb_flightsuit_suit_01_01_07	アイテムタイプフライトスーツ\nダメージ軽減15%\n温度レーティング: -30 / 60 �C\n\n何世紀にもわたる技術革新により完成した、Syang Fabricationの洗練されたスタイリッシュなザンスールフライトスーツは、人間の体格に合わせ細心の注意を払って作られています。通気性に優れたカーボンシルク織りの軽量メッキを採用し、信頼性の高いプロテクションを提供しながら、メゾンの特徴である美的感覚を損なわない。	
item_Desc_thp_gloves_01,P	PH - thp_gloves_01	
item_Desc_thp_light_arms_01	アイテムタイプライトアーマー\nダメージ軽減率: 20%\n温度レーティング: -38 / 68 �C\n\nアズタランのアーマーを身につければ、辺境を恐れることはない。メッキと補強された生地が組み合わされたこのアーマーは、安全でありながら迅速な行動を可能にする。テハチャピの卓越したデザインにより、フロンティアスタイルでありながら、収納性に優れている。砂丘から賑やかな裏通りまで、アズタランはあなたの次の冒険に理想的な選択です。	
item_Desc_thp_light_core_01	アイテムタイプライトアーマー\nダメージ軽減率：20\nキャリー容量：8K�SCU\n温度定格温度：-35 / 65\nバックパック互換性ライト\n\nアズタランのアーマーを身につければ、辺境も怖くない。アーマープレーティングと補強されたファブリックの組み合わせは、安全でありながら迅速な行動を可能にします。テハチャピの卓越したデザインにより、アーマーは繊細でありながら紛れもないフロンティアスタイルで、十分な収納力も備えている。砂丘から賑やかな裏通りまで、アズタランはあなたの次の冒険に理想的な選択です。	
item_Desc_thp_light_helmet_01	アイテムタイプライトアーマー\nダメージ軽減率: 20%\n温度レーティング: -32 / 64 �C\n\nアズタラン・アーマーを身につければ、辺境も怖くない。鎧のメッキと補強された生地が、安全でありながら迅速な行動を可能にする。テハチャピの卓越したデザインにより、フロンティアスタイルでありながら、収納性に優れています。砂丘から賑やかな裏通りまで、アズタランはあなたの次の冒険に理想的な選択です。	
item_Desc_thp_light_legs_01	アイテムタイプライトアーマー\nダメージ軽減率：20\n携帯能力：5K�SCU\n温度定格温度：-38 / 68\n\nアズタラン・アーマーを身につければ、辺境も怖くない。メッキと補強されたファブリックの組み合わせは、安全でありながら迅速な行動を可能にします。テハチャピの卓越したデザインにより、フロンティアスタイルでありながら、収納性に優れている。砂丘から賑やかな裏通りまで、アズタランはあなたの次の冒険に理想的な選択です。	
item_Desc_thp_medium_helmet_01,P	PH - thp_medium_helmet_01	-
item_Desc_thp_medium_jacket_01,P	PH - thp_medium_jacket_01	-
item_Desc_thp_pants_01,P	PH - thp_pants_01	-
item_Desc_uba_prison_backpack_01	アイテムタイプ軽量バックパック\n容量： 50K �SCU\nコアの互換性すべて\n\nこの頑丈な収容者用ワークパックは、十分な収納力を備え、着用者の背中に均等に重量が分散されるため、毎回のシフト中に多くの荷物を持ち運ぶことができます。また、囚人ごとに酸素ボンベのサイズを決められるよう、底のストラップがしっかり固定されており、脱走のリスクを最小限に抑えます。	
item_Desc_uba_prison_undersuit_01	アイテムタイプワークスーツ\nダメージ軽減10%\n温度レーティング: -75 / 75 �C\n\n受刑者用ワークスーツは、受刑者が労働解放プログラム中に直面することの多い過酷な状況に耐えられるよう設計された、耐久性と視認性に優れたワークスーツです。このワークスーツには、保護用の補強パッドが内蔵され、丈夫な合成繊維の編み込みにより、コストを抑えながら、政府の定める最低限の保温基準を満たしています。頑丈なワークパックは十分な収納力を備え、着用者の背中に均等に重量を分散させるため、毎回のシフト中に多くの荷物を持ち運ぶことができる。また、囚人ごとに酸素ボンベのサイズを決められるよう、底のストラップがしっかり固定されているため、脱走のリスクを最小限に抑えることができます。	
item_Desc_uba_prison_undersuit_helmet_01	アイテムタイプワークスーツ・ヘルメット\nダメージ軽減10%\n温度レーティング: -75 / 75 �C\n\n収監者用作業ヘルメットは、目視で容易に追跡できる視認性の高いデザインに加え、曇り止め、落下物にも耐える強化メッキに密封された耐クラック性のフェースプレートが特徴です。	
item_Desc_vgl_advocacy_lightarmor_Shared	アイテムタイプライトアーマー\nダメージ軽減率: 20%\n温度レーティング: -38 / 68 �C\n\nバージルのTrueDefシリーズは、素早く機動性を保ちながら、重要な部位を戦略的に保護するボディアーマーです。数多くの惑星法執行機関やアドボカシーでさえ、TrueDefのバージョンを使用して、役員やエージェントを保護しています。	
item_Desc_vgl_advocacy_lightarmor_helmet_01	アイテムタイプライトアーマー\nダメージ軽減率: 20%\n温度レーティング: -38 / 68 �C\n\nヴァージルのArgusヘルメットは、先進的な多層複合構造を採用し、武器の射撃や環境の危険から驚異的なプロテクションを提供する。着色されたバイザーは広い視野を提供し、状況認識と自由な動きを向上させる。	
item_Desc_vgl_advocacy_lightarmor_legs_01	アイテムタイプライトアーマー\nダメージ軽減率：20\n携帯能力：3K�SCU\n温度定格温度：-38 / 68\n\nバージルのTrueDefシリーズは、迅速かつ機動性を保ちながら、重要な部位を戦略的に保護する防護服です。数多くの惑星法執行組織とアドボカシーでさえ、役員やエージェントを保護するためにTrueDefのバージョンを使用しています。"	
item_Desc_vgl_armor_light_arms_01_01_9tails01	アイテムタイプライトアーマー\nダメージ軽減率: 20%\n温度レーティング: -38 / 68 �C\n\nバージルのTrueDef-Proアームのオリジナルバージョン。バージルのTrueDefシリーズの防護服は、重要な部位を戦略的に保護し、素早く機動的に動くことができる。数多くの惑星法執行機関やアドボカシーでさえ、TrueDefのバージョンを使用して、役員やエージェントを保護しています。	
item_Desc_vgl_armor_light_core_01_01_9tails01	アイテムタイプライトアーマー\nダメージ軽減率：20\n携帯能力：5K�SCU\n温度耐温度：-35 / 65\nバックパック互換性ライト\n\nバージルのTrueDef-Proのコアをオリジナルから改良したバージョン。バージルのTrueDefシリーズは、素早く機動性を保ちながら、重要な部位を戦略的に保護するボディアーマーです。多数の惑星の法執行組織および Advocacy は彼らの役人および代理人を保護するのにTrueDef の版を使用する。	
item_Desc_vgl_armor_light_core_01_01_Shared	アイテムタイプライトアーマー\nダメージ軽減率：20\n携帯能力：5K�SCU\n温度耐温度：-35 / 65\nバックパック互換性ライト\n\nバージルのTrueDefシリーズは、素早く機動性を保ちながら、重要な部位を戦略的に保護するボディアーマーです。数多くの惑星法執行組織とアドボカシーでさえ、役員やエージェントを保護するためにTrueDefのバージョンを使用しています。	
item_Desc_vgl_armor_medium_helmet_01_Shared	アイテムタイプミディアム・アーマー\nダメージ軽減30%\n温度レート: -61 / 91 �C\n\nパラディンはヴァージルの産業部門から生まれたヘルメットで、サルベージや修理作業用のプロトタイプとして開発された。しかし、その印象的なデザインに感銘を受けた同社幹部は、このヘルメットをパーソナル・アーマー・ラインに統合した。ヘルメットの外観はそのままに、フレームに戦闘用で耐久性のある合金を使用し、後頭部を保護するメッキを強化した。	
item_Desc_vgl_specialist_heavy_helmet_01	アイテムタイプヘビーアーマー\nダメージ軽減40%\n温度レーティング: -90 / 115 �C\n\nVigilのSangarヘルメットは、ヘルメットの特殊な耐衝撃インナーを通して衝撃を吸収、分散させることを意味する顕著な眉の隆起のおかげで、実用的かつ人目を引く。目の上の高品質ダイヤモンドラミネートレンズと、牙のように前面から突き出た最高級のデュアルセンサー空気ろ過システムを特徴とするバージルは、Sangarヘルメットが敵対的な環境から必死の銃撃戦まで、あらゆる状況下で打撃を受け、見栄えがすることを保証している。	
item_Desc_vgl_specialist_heavy_helmet_01_01_9tails01	アイテムタイプヘビーアーマー\nダメージ軽減40%\n温度レーティング: -90 / 115 �C\n\nバージルのサンガーヘルメットをオリジナルから改良したバージョン。VigilのSangarヘルメットは実用的でありながら、目を引くデザインとなっている。眉間のリッジは、ヘルメットの耐衝撃インナーを通して衝撃を吸収、分散させる。目の上の高品質のダイヤモンドラミネートレンズと、牙のように前面から突き出た最高級のデュアルセンサー空気濾過システムを特徴とするバージルは、サンガーヘルメットが敵対的な環境から必死の銃撃戦まで、あらゆる状況で打撃を受け、見栄えがすることを保証した。	
item_Desc_vgl_specialist_light_core_01_01_xenothreat	アイテムタイプライトアーマー\nダメージ軽減率：20\n携帯能力：5K�SCU\n温度耐温度：-35 / 65\nバックパック互換性ライト\n\nバージルのTrueDefシリーズは、素早く機動性を保ちながら、重要な部位を戦略的に保護するボディアーマーです。数多くの惑星法執行組織とアドボカシーでさえ、TrueDefのバージョンを使用して、役員やエージェントを保護しています。この特別バージョンは、前面と背面に民間防衛軍のロゴを配することで、大きな必要性のある時に法執行機関や海軍と共に勇敢に戦う人々に敬意を表しています。	
item_Desc_vgl_undersuit_01_01_Shared	アイテムタイプアンダースーツ\nダメージ軽減10%\n温度レーティング: -30 / 60 �C\n\nバージルのフォースフレックスは次世代のアンダースーツ技術です。戦闘だけでなく、工業作業にも使用できるコンボウィーブは、どのような状況下でも体を守り続ける。	
item_Descnone_shotgun_ballistic_01	製造元: 不明\nアイテムタイプ: ショットガン\nクラス: 実弾\n\nマガジンサイズ: 8\n射撃速度: 120 rpm\n有効射程: 0-10 m\n\nアタッチメント: 不明\n\nDeadrigは、ジャンクヤードのくず鉄から組み立てられたシンプルなデザインの高威力ダブルバレルショットガンです。他のすべてよりも威力を重視し、大量生産された武器の洗練さは一つもありません。射撃時は強力な反動を放ちます。	mossy
item_Descnone_shotgun_ballistic_01_mag	アイテムタイプ: マガジン\n容量: 8\n\nDeadrigショットガン用のこのマガジンには8発の12ゲージシェルが装填されています。	mossy
item_NameCutter_Paint_Black_Cyan	Cutter『Nightfall』ペイント	exceptur
item_NameCutter_Paint_Olive_White_Orange	Cutter『Caiman』ペイント	exceptur
item_NameCutter_Paint_Orange_Grey_Stripe	Cutter『Rockslide』ペイント	exceptur
item_NameDragonfly_Paint_Citcon2953_Beige_Tan_Beige	Dragonfly『Roustabout』ペイント（改造済み）	exceptur
item_NameFlair_Coin_1_f	Zeus記念コイン	exceptur
item_NameFlair_Model_HullC_2_takuetsu_box	Hull C プラモデル	exceptur
item_NameFlair_Poster_HT_BIS_1_a	Vulture 2953 Ship Showdown ポスター	exceptur
item_NameFlair_Poster_HT_BIS_1_b	Corsair 2953 Ship Showdown ポスター	exceptur
item_NameFlair_Poster_HT_BIS_1_c	Redeemer 2953 Ship Showdown ポスター	exceptur
item_NameFlair_Poster_HT_BIS_1_d	600i 2953 Ship Showdown ポスター	exceptur
item_NamePlushy_zeus_1_a	Zeusぬいぐるみ	exceptur
item_NameSpirit_A1_Paint_Green_Black_Orange	Spirit『Intrepid』ペイント	exceptur
item_NameSpirit_Paint_Black_Blue_White	Spirit『Valor』ペイント	exceptur
item_NameSpirit_Paint_Grey_Grey_Blue	Spirit『Resolute』ペイント	exceptur
item_NameSpirit_Paint_Maroon_Beige_Blue	Spirit『Ruby』ペイント	exceptur
item_NameSpirit_Paint_White_Blue_Black	Spirit『Ardent』ペイント	exceptur
item_Name_987_shirt_04_01_01	テンポスタンク・セーブル	
item_Name_987_shirt_04_01_13	テンポス・タンク ダークアンバー	
item_Name_987_shirt_04_01_15	テンポス・タンク オリーブ	
item_Name_987_shirt_04_01_16	テンパス・タンク グレー	
item_Name_987_shirt_04_01_17	テンポス・タンク チャコール	
item_Name_CDS_Undersuit_Armor_01_01_12	TCS-4 アンダースーツ�ブラック／グレー	
item_Name_alb_jumpsuit_01_01_01	バノック・ジャンプスーツ ウォーム・アッシュ	
item_Name_alb_jumpsuit_01_01_04	バノック・ジャンプスーツ グリーン	
item_Name_alb_jumpsuit_01_01_07	バノック・ジャンプスーツ・ブルー	
item_Name_alb_jumpsuit_01_01_10	バノック・ジャンプスーツ	
item_Name_alb_jumpsuit_01_01_11	バノック・ジャンプスーツ ブラック	
item_Name_alb_mask_03_01_01	サルーク マスク ブラウン	
item_Name_alb_mask_03_01_04,P	サルーク・マスク オリーブ	
item_Name_alb_mask_03_01_18	サルーク・マスク コバルト	
item_Name_alb_pants_03_01_01	オールパ・パンツ ブラウン	
item_Name_alb_pants_03_02_01	オールパ・パンツ・シャドウ	
item_Name_alb_pants_03_03_01	オールパ・パンツ・オリーブ	
item_Name_cbd_hat_03_cvx01_01	コバレックスの帽子	
item_Name_cbd_hat_03_itg_01	ITGハット	
item_Name_cbd_hat_03_ling_01	リン・ハット	
item_Name_cbd_hat_03_redwind_01	赤い風帽子	
item_Name_cbd_hat_03_taba_01	TABAハット	
item_Name_cbd_hat_03_unified_01	UDFハット	
item_Name_cbd_pants_05_01_01	クーサージーンズ・スモーク	
item_Name_cbd_pants_05_01_12	クーサージーンズのピッチ	
item_Name_cbd_pants_05_01_13	クーサージーンズ・ラスト	
item_Name_cbd_pants_05_01_16	カーサージーンズ チャコール	
item_Name_cbd_pants_05_01_17	コーサージーンズ・リード	
item_Name_clda_gloves_01_01_01	バダミ グローブ デッドウッド	
item_Name_clda_gloves_01_02_01	バダミ・グローブ グラファイト	
item_Name_clda_gloves_01_03_01	バダミ・グローブ・オリヴィン	
item_Name_clda_helmet_01_01_01	バダミ・ヘルメット デッドウッド	
item_Name_clda_helmet_01_02_01	バダミ・ヘルメット グラファイト	
item_Name_clda_helmet_01_03_01	バダミ・ヘルメット・オリヴィン	
item_Name_dmc_frontier_gloves_01_01_01	アドロイト・グローブ チャコール	
item_Name_dmc_frontier_gloves_01_01_15	アドロイト・グローブ セージ	
item_Name_dmc_frontier_gloves_01_01_16	アドロイト・グローブ・ジェイド	
item_Name_dmc_frontier_gloves_01_01_17	アドロイト・グローブ インディゴ	
item_Name_dmc_frontier_gloves_01_01_20	アドロイト・グローブ オリーブ	
item_Name_dmc_frontier_jacket_01_01_01	シルバートン・ジャケット ブラウン	
item_Name_dmc_frontier_jacket_01_01_15	シルバートン・ジャケット タン	
item_Name_dmc_frontier_jacket_01_01_16	シルバートン・ジャケット・パイン	
item_Name_dmc_frontier_jacket_01_01_17	シルバートン・ジャケット ブルー	
item_Name_dmc_frontier_jacket_01_01_20	シルバートン・ジャケット オニキス	
item_Name_dmc_frontier_pants_01_01_01	シルバートン・パンツ チャコール	
item_Name_dmc_frontier_pants_01_01_15	シルバートン・パンツ セージ	
item_Name_dmc_frontier_pants_01_01_16	シルバートン・パンツ・ジェイド	
item_Name_dmc_frontier_pants_01_01_17	シルバートン・パンツ インディゴ	
item_Name_dmc_frontier_pants_01_01_20	シルバートン・パンツ オリーブ	
item_Name_dmc_jacket_05_01_01	コロマ・コート ネイビー＆セージ	
item_Name_dmc_jacket_05_01_07	コロマ・コート ブルー＆ブリック	
item_Name_dmc_jacket_05_01_10	コロマ・コート アイス＆アイアン	
item_Name_dmc_jacket_05_01_11	コロマ・コート アイアン＆シルバー	
item_Name_dmc_jacket_05_01_15	コロマ・コート セージ＆ネイビー	
item_Name_dmc_jacket_06_01_01	カルドナ・ジャケット サンド	
item_Name_dmc_jacket_06_01_12	カルドナ ジャケット・アイロン	
item_Name_dmc_jacket_06_01_13	カルドナ ジャケット カーマイン	
item_Name_dmc_jacket_06_01_14	カルドナジャケット イエロー	
item_Name_dmc_jacket_06_01_18	カルドナ・ジャケット ブルー	
item_Name_dmc_jacket_07_01_01	カスワール・ジャケット トープ	
item_Name_dmc_jacket_07_01_11	カスワール・ジャケット・アイロン	
item_Name_dmc_jacket_07_01_13	カスワール・ジャケット・ブリック	
item_Name_dmc_jacket_07_01_16	カスワール・ジャケット・パイン	
item_Name_dmc_jacket_07_01_20	カスワール・ジャケット サンド	
item_Name_dmc_jacket_10_01_01	キーストーン・ジャケット トープ	
item_Name_dmc_jacket_10_01_12	キーストーン・ジャケット オニキス	
item_Name_dmc_jacket_10_01_13	キーストーン・ジャケット レッド	
item_Name_dmc_jacket_10_01_14	キーストーン・ジャケット・ゴールド	
item_Name_dmc_jacket_10_01_15	キーストーン・ジャケット シルバー	
item_Name_dmc_pants_07_01_01	フロンティア11 クラシックサンド	
item_Name_dmc_pants_07_01_13	フロンティア11 クラシックブリック	
item_Name_dmc_pants_07_01_16	フロンティア11 クラシック・パイン	
item_Name_dmc_pants_07_01_17	フロンティア11 クラシックネイビー	
item_Name_dmc_pants_07_01_18	フロンティア11 クラシック・オニキス	
item_Name_dmc_shirt_01_01_01	グリーンウォーターシャツ ウォールナット	
item_Name_dmc_shirt_01_02_01	グリーンウォーター・シャツ・アイロン	
item_Name_dmc_shirt_01_03_01	グリーンウォーター・シャツ・オリーブ	
item_Name_grin_toxic_jumpsuit_01_01_01	トゥルーバリア ハザードスーツ モス	
item_Name_grin_toxic_jumpsuit_01_01_02	トゥルーバリアハザードスーツ シナバー	
item_Name_grin_toxic_jumpsuit_01_01_04	トゥルーバリアハザードスーツ ハイビスイエロー	
item_Name_grin_toxic_jumpsuit_01_01_07	トゥルーバリア ハザードスーツ コバルト	
item_Name_grin_toxic_jumpsuit_01_01_11	トゥルーバリア ハザードスーツ スレート	
item_Name_grin_toxic_mask_01_01_01	トゥルーバリア ハザードスーツ マスク・モス	
item_Name_grin_toxic_mask_01_01_02	トゥルーバリア ハザードスーツ マスク シナバー	
item_Name_grin_toxic_mask_01_01_04	トゥルーバリア ハザードスーツ マスク ハイビスイエロー	
item_Name_grin_toxic_mask_01_01_07	トゥルーバリア ハザードスーツ マスク コバルト	
item_Name_grin_toxic_mask_01_01_11	トゥルーバリア ハザードスーツ マスク スレート	
item_Name_gsb_boots_10_01_01	デザート・キャット・ブーツ	
item_Name_gsb_shoes_05_01_01,P	PH - gsb_shoes_05_01_01	
item_Name_hdh_hat_04_01_01	ケルダーハットとインディゴゴーグル	
item_Name_hdh_hat_04_01_04	ケルデュールハットとクルミのゴーグル	
item_Name_hdh_hat_04_01_07	ケルダーの帽子とヒッコリーのゴーグル	
item_Name_hdh_hat_04_01_10	ケルドゥール・ハットとミッドナイト・ゴーグル	
item_Name_hdh_hat_04_01_11	ケルダーハットとオークゴーグル	
item_Name_hdh_jacket_05_01_01	タルシージャケット コニファー	
item_Name_hdh_jacket_05_01_02	タルシージャケット レッドウッド	
item_Name_hdh_jacket_05_01_03	タルシ・ジャケット オリーブ	
item_Name_hdh_jacket_05_01_07	タルシージャケット・ミッドナイト	
item_Name_hdh_jacket_05_01_11	タルシージャケット エボニー	
item_Name_hdh_jacket_06_01_01	ヴァチャ・ジャケット・サンダルウッド	
item_Name_hdh_jacket_06_01_13	ヴァシャ・ジャケット マホガニー	
item_Name_hdh_jacket_06_01_16	ヴァシャ・ジャケット・スプルース	
item_Name_hdh_jacket_06_01_17	ヴァシャ・ジャケット・ミッドナイト	
item_Name_hdh_jacket_06_01_18	ヴァーチャ・ジャケット エボニー	
item_Name_hdh_pants_01_01_01	ゼレーナ・パンツ コニファー＆ビスビー・ブーツ	
item_Name_hdh_pants_01_01_02	ゼレーナ・パンツ レッドウッド＆ビスビー・ブーツ	
item_Name_hdh_pants_01_01_03	ゼレーナ・パンツ オリーブ×ビスビー・ブーツ	
item_Name_hdh_pants_01_01_07	ゼレーナ・パンツ・ミッドナイト＆ビスビー・ブーツ	
item_Name_hdh_pants_01_01_11	ゼレーナ・パンツ エボニー＆ビスビー・ブーツ	
item_Name_hdh_pants_02_01_02,P	PH - hdh_pants_02_01_02	-
item_Name_hdh_pants_02_01_03,P	PH - hdh_pants_02_01_03	-
item_Name_hdh_pants_02_01_07,P	PH - hdh_pants_02_01_07	-
item_Name_hdh_pants_02_01_11,P	PH - hdh_pants_02_01_11	-
item_Name_nvs_jumpsuit_01_03_02	ファルストン ジャンプスーツ "リン・エディション"	
item_Name_nvs_jumpsuit_01_04_17	ファルストン ジャンプスーツ "TABA Edition"	
item_Name_nvs_jumpsuit_01_05_07	ファルストン ジャンプスーツ "ITG Edition"	
item_Name_nvs_jumpsuit_01_06_11	ファルストン ジャンプスーツ "赤い風エディション"	
item_Name_nvs_jumpsuit_01_07_09	ファルストン ジャンプスーツ "UDFエディション"	
item_Name_nvs_jumpsuit_01_08_12	ファルストン ジャンプスーツ "コバレックス・エディション"	
item_Name_outlaw_legacy_light_armor_helmet	オラクル�ヘルメットベース	
item_Name_outlaw_legacy_light_armor_legs	リンクス�レッグスベース	
item_Name_r6p_boots_04_01_01	セラード・ブーツ・ウッド	
item_Name_r6p_boots_04_01_04	セラード・ブーツ・ブロンズ	
item_Name_r6p_boots_04_01_18	セラード・ブーツ スレート	
item_Name_r6p_boots_05_01_01	タッソック・ブーツ・コール	
item_Name_r6p_boots_05_01_12	タソックブーツ・オリヴィーヌ	
item_Name_r6p_boots_05_01_13	タソックブーツ・バサルト	
item_Name_r6p_boots_05_01_16	タソックブーツ ヘマタイト	
item_Name_r6p_boots_05_01_17	タソック・ブーツ・グラベル	
item_Name_r6p_gloves_02_01_01	アスター・グローブ サンド	
item_Name_r6p_gloves_02_01_04	アスター・グローブ・モス	
item_Name_r6p_gloves_02_01_18	アスター・グローブ トワイライト	
item_Name_rrs_specialist_light_arms_01_coramor_01	アーデン-SL アームズ コラモール エディション "フェイト"	
item_Name_rrs_specialist_light_arms_01_coramor_02	アーデン-SL アームズ コラモール エディション "キスメット"	
item_Name_rrs_specialist_light_core_01_coramor_01	アーデン-SL コア・コラモール・エディション "Fate"	
item_Name_rrs_specialist_light_core_01_coramor_02	アーデン-SL コア・コラモール・エディション "キスメット"	
item_Name_rrs_specialist_light_helmet_01_coramor_01	Arden-SLヘルメット Coramorエディション "Fate"	
item_Name_rrs_specialist_light_helmet_01_coramor_02	Arden-SL ヘルメット Coramor エディション "Kismet"	
item_Name_rrs_specialist_light_legs_01_coramor_01	アーデン-SLレッグス コラモール・エディション "Fate"	
item_Name_rrs_specialist_light_legs_01_coramor_02	アーデン-SLレッグス コラモール・エディション "キスメット"	
item_Name_scu_pants_04_01_01	カレットパンツ ダークグレー	
item_Name_scu_pants_04_01_07	カレットパンツ ネイビーブルー	
item_Name_scu_pants_04_01_10	カレットパンツ ライトグレー	
item_Name_scu_pants_04_01_11	カレットパンツ チャコール	
item_Name_scu_pants_04_01_15	カレットパンツ アーミーグリーン	
item_Name_slaver_medium_armor_02_core	ダストアップコア	
item_Name_srvl_jacket_01_01_01	ラスティック・ジャケット・ブラウン	
item_Name_srvl_jacket_01_01_04	ラスティック・ジャケット・グリーン	
item_Name_srvl_jacket_01_01_18	ラスティック・ジャケット・ブルー	
item_Name_srvl_jacket_02_01_01	ピースミールジャケット ブラウン	
item_Name_srvl_jacket_02_02_01	ピースミールジャケット グレー	
item_Name_srvl_jacket_02_03_01	ピースミールジャケット オリーブ	
item_Name_srvl_pants_01_01_01	レストア・パンツ・ブラウン	
item_Name_srvl_pants_01_01_04	レストア・パンツ・グリーン	
item_Name_srvl_pants_01_01_18	レストア・パンツ ブルー	
item_Name_srvl_shirt_01_01_01,P	グッドイナフ・シャツ ブラウン	
item_Name_srvl_shirt_01_01_04	グッドイナフ・シャツ グリーン	
item_Name_srvl_shirt_01_01_18	グッドイナフ・シャツ ブルー	
item_Name_thp_gloves_01_01_01,P	PH - thp_gloves_01_01	-
item_Name_thp_gloves_01_02_01,P	PH - thp_gloves_01_02_01	-
item_Name_thp_medium_helmet_01_01_01,P	PH - thp_中型ヘルメット_01_01_01	-
item_Name_thp_medium_helmet_01_02_01,P	PH - thp_medium_helmet_01_02_01	-
item_Name_thp_medium_jacket_01_01_01,P	PH - thp_medium_jacket_01_01	-
item_Name_thp_medium_jacket_01_02_01,P	PH - thp_medium_jacket_01_02_01	-
item_Name_thp_pants_01_01_01,P	PH - thp_pants_01_01_01	-
item_Name_thp_pants_01_02_01,P	PH - thp_pants_01_02_01	-
item_Namenone_shotgun_ballistic_01	Deadrig ショットガン	exceptur
item_Namenone_shotgun_ballistic_01_mag	Deadrig ショットガンマガジン（8発）	exceptur
item_Namenone_shotgun_ballistic_01_short	ショットガン	exceptur
item_SubTypeScraperBeam	Scraper ビーム	exceptur
items_commodities_pressurized_ice,P	氷(加圧)	mossy
items_commodities_pressurized_ice_desc,P	圧縮することで、膨張する性質を制限して透明に精製した氷です。これにより大量かつ効率的な輸送が可能になります。	mossy
items_commodities_riccite,P	Riccite	mossy
items_commodities_riccite_des,P	RicciteはRiccite鉱石から製錬できます。	mossy
items_commodities_stileron,P	Stileron	mossy
items_commodities_stileron_desc	Stileronは精製が非常に難しく、採掘よりもさらに困難です。その用途がなければ、その努力に値するものではないでしょう。	mossy
items_commodities_tin,P	スズ	mossy
items_commodities_tin_desc	スズはしなやかで柔らかい金属で、銀白色から青みがかった白色をしています。導電性があり、対腐食性を持ちます。	mossy
mg_pacheco_DestroyEvidence_desc_001	~mission(location|address)のセキュリティが、存在しないはずの証拠の箱を手に入れたことがわかった。金を払うから破棄してくれ。\n\n証拠品を手に入れるのは簡単なことじゃない。ステーションの砲塔と厳重な警備をくぐり抜け、証拠保管庫へのアクセスコードを手に入れるために警備主任を倒さなければならない。チーフは高レベルの緊急事態にしか対処しないので、彼らが現れる価値があると感じる前に、かなり撃ちまくる必要があると思う。クルーを同行させ、慎重にステーションに近づくのがいい考えだろう。\n\n証拠品保管システムを立ち上げれば、欲しい箱は簡単に見つかるはずだ。青色で「EVIDENCE」と書いてある。それを破壊すれば、報酬を受け取れる。\n\nその後どうするかは君次第だ。証拠保管庫には他にも貴重なガラクタがたくさんあるだろうから、それを手に入れるために十分な時間、その辺をウロウロする気があるのなら、それは君の自由だ。\n\n-Twitch\n	
mg_pacheco_StealEvidence_desc_001	手短に言うと、私の部下の一人が、私と私の仲間の何人かを非常に不愉快にさせる可能性のある証拠をつかまされた。だから、君には~mission(location|address)へ行って、それを盗んできてほしいんだ。\n\n簡単ではない。ステーションは砲台に守られ、警備がうようよしているだけでなく、証拠保管庫を起動するためのアクセスコードは警備主任が保管している。それを手に入れるには、チーフが直接対応に来ざるを得ないほどの大混乱を作り出す必要がある。普段は派手で面倒なことは好きではないが、この仕事では必要だ。慎重にステーションに近づき、クルーも同行させるのも悪くないだろう。\n\nいい面もある。私が欲しい証拠は簡単に見つけられるはずだ。箱は青色で、側面に "EVIDENCE "と書いてある。私が最優先だということを忘れないでくれれば、倉庫から取って売りたいものは何でも構わない。\n\n僕の証拠を手に入れたら、それを~mission(destination|address)に置いてくれれば、今日はそれで終わりにしよう。\n\n-スイッチ\n	
mg_pacheco_StealEvidence_desc_002	詳細は省くが、厄介な交渉にはちょっとした影響力が必要で、どこでそれを手に入れられるかよく知っている。だから君に~mission(location|address)に行って、証拠の箱を盗んできてほしいんだ。\n \n君に嘘はつかない。この仕事は難しい。ステーションは砲塔と警備が厳重で、証拠品保管庫へのアクセスコードは警備主任が持っているだけだ。さらに悪いことに、あの鼻つまみ者は本格的な緊急事態でない限り、自分の手を汚したがらない。つまり、チーフがわざわざやってくる前に、事態をエスカレートさせなければならない。\n\n証拠品保管システムを起動させれば、私が欲しい箱が最初に出てくるはずだ。その後にもっと箱が出てくるかもしれないが、それはボーナスの支払いだと思えばいい。\n\nただ、私の証拠品を~mission(destination|address)に届けることを一番に考えておいてくれ。\n\n君が慎重にステーションに近づき、適切なクルーを連れてくれば、我々は皆、欲しいものを手に入れることができるはずだ。\n\n-トウィッチ\n	
mg_ruto_RetrieveConsignment_desc_001	ああ、こんにちは、最近ちょっと小耳に挟んだんだけど、~mission(location|address)が僕の知人にとって非常に興味深い機密資料を受け取ったらしいんだ。とても興味深いので、誰かがその施設を襲撃し、商品を奪い取って、それを~mission(DropOff1|address)に届けるために喜んで金を払うそうだ。警備員はたくさんいるだろうし、抵抗してくるだろうから、銃の1丁や2丁は持っていくだろう。\n\n機密資料は他のものと一緒に委託配送され、現在は施設の自動保管庫に保管されているとのことだ。現場の上級警備員は、保管庫にアクセスするための検索コードが入ったデータパッドを持っている。箱の回収に荷物コンベアを使う前に、データパッドを手に入れなければならない。\n\nもし少し甘い言葉が必要なら、私はマニフェストを見たし、施設に保管されている他の木箱がかなり選りすぐりのものであることを確認できる。私のクライアントはそれがどうなろうと知ったことではない。うまくやれば、余分な木箱は配達料の上乗せになる。	
mission_location_stanton_617	REC-A	exceptur
mission_location_stanton_618	Cloudrest Retreat内、RecreationプラットフォームのA棟	exceptur
mission_location_stanton_619	REC-B	exceptur
mission_location_stanton_620	Cloudrest Retreat内、RecreationプラットフォームのB棟	exceptur
mission_location_stanton_621	REC-C	exceptur
mission_location_stanton_622	Cloudrest Retreat内、RecreationプラットフォームのC棟	exceptur
mission_location_stanton_623	REC-D	exceptur
mission_location_stanton_624	Cloudrest Retreat内、RecreationプラットフォームのD棟	exceptur
mission_location_stanton_625	REC-E	exceptur
mission_location_stanton_626	Cloudrest Retreat内、RecreationプラットフォームのE棟	exceptur
mission_location_stanton_627	REC-F	exceptur
mission_location_stanton_628	Cloudrest Retreat内、RecreationプラットフォームのF棟	exceptur
mission_location_stanton_629	REC-G	exceptur
mission_location_stanton_630	Cloudrest Retreat内、RecreationプラットフォームのG棟	exceptur
mission_location_stanton_631	REC-H	exceptur
mission_location_stanton_632	Cloudrest Retreat内、RecreationプラットフォームのH棟	exceptur
mission_location_stanton_633	REC-I	exceptur
mission_location_stanton_634	Cloudrest Retreat内、RecreationプラットフォームのI棟	exceptur
mission_location_stanton_635	RSRT-A	exceptur
mission_location_stanton_636	Cloudrest Retreat内、ResortプラットフォームのA棟	exceptur
mission_location_stanton_637	RSRT-B	exceptur
mission_location_stanton_638	Cloudrest Retreat内、ResortプラットフォームのB棟	exceptur
mission_location_stanton_639	RSRT-C	exceptur
mission_location_stanton_640	Cloudrest Retreat内、ResortプラットフォームのC棟	exceptur
mission_location_stanton_641	RSRT-D	exceptur
mission_location_stanton_642	Cloudrest Retreat内、ResortプラットフォームのD棟	exceptur
mission_location_stanton_643	RSRT-A	exceptur
mission_location_stanton_644	Cloudrest Retreat内、ResortプラットフォームのA棟	exceptur
mission_location_stanton_645	RSRT-B	exceptur
mission_location_stanton_646	Cloudrest Retreat内、ResortプラットフォームのB棟	exceptur
mission_location_stanton_647	RSRT-C	exceptur
mission_location_stanton_648	Cloudrest Retreat内、ResortプラットフォームのC棟	exceptur
mission_location_stanton_649	RSRT-D	exceptur
mission_location_stanton_650	Cloudrest Retreat内、ResortプラットフォームのD棟	exceptur
mission_location_stanton_651	REZ-A	exceptur
mission_location_stanton_652	Empyrean Park内、ResidencyプラットフォームのA棟	exceptur
mission_location_stanton_653	REZ-B	exceptur
mission_location_stanton_654	Empyrean Park内、ResidencyプラットフォームのB棟	exceptur
mission_location_stanton_655	REZ-C	exceptur
mission_location_stanton_656	Empyrean Park内、ResidencyプラットフォームのC棟	exceptur
mission_location_stanton_657	REZ-D	exceptur
mission_location_stanton_658	Empyrean Park内、ResidencyプラットフォームのD棟	exceptur
mission_location_stanton_659	REZ-E	exceptur
mission_location_stanton_660	Empyrean Park内、ResidencyプラットフォームのE棟	exceptur
mission_location_stanton_661	REZ-F	exceptur
mission_location_stanton_662	Empyrean Park内、ResidencyプラットフォームのF棟	exceptur
mission_location_stanton_663	REZ-G	exceptur
mission_location_stanton_664	Empyrean Park内、ResidencyプラットフォームのG棟	exceptur
mission_location_stanton_665	REZ-H	exceptur
mission_location_stanton_666	Empyrean Park内、ResidencyプラットフォームのH棟	exceptur
mission_location_stanton_667	REZ-I	exceptur
mission_location_stanton_668	Empyrean Park内、ResidencyプラットフォームのI棟	exceptur
mission_location_stanton_669	ADMN-A	exceptur
mission_location_stanton_670	Empyrean Park内、AdminプラットフォームのA棟	exceptur
mission_location_stanton_671	RSRT-A	exceptur
mission_location_stanton_672	Prospect Point内、AdminプラットフォームのA棟	exceptur
mission_location_stanton_673	RSRT-B	exceptur
mission_location_stanton_674	Prospect Point内、AdminプラットフォームのB棟	exceptur
mission_location_stanton_675	RSRT-C	exceptur
mission_location_stanton_676	Prospect Point内、AdminプラットフォームのC棟	exceptur
mission_location_stanton_677	RSRT-D	exceptur
mission_location_stanton_678	Prospect Point内、AdminプラットフォームのD棟	exceptur
mission_location_stanton_679	RSRT-A	exceptur
mission_location_stanton_680	Prospect Point内、ResortプラットフォームのA棟	exceptur
mission_location_stanton_681	RSRT-B	exceptur
mission_location_stanton_682	Prospect Point内、ResortプラットフォームのB棟	exceptur
mission_location_stanton_683	RSRT-C	exceptur
mission_location_stanton_684	Prospect Point内、ResortプラットフォームのC棟	exceptur
mission_location_stanton_685	RSRT-D	exceptur
mission_location_stanton_686	Prospect Point内、ResortプラットフォームのD棟	exceptur
mission_location_stanton_687	REC-A	exceptur
mission_location_stanton_688	Prospect Point内、RecreationプラットフォームのA棟	exceptur
mission_location_stanton_689	REC-B	exceptur
mission_location_stanton_690	Prospect Point内、RecreationプラットフォームのB棟	exceptur
mission_location_stanton_691	REC-C	exceptur
mission_location_stanton_692	Prospect Point内、RecreationプラットフォームのC棟	exceptur
mission_location_stanton_693	REC-D	exceptur
mission_location_stanton_694	Prospect Point内、RecreationプラットフォームのD棟	exceptur
mission_location_stanton_695	REC-E	exceptur
mission_location_stanton_696	Prospect Point内、RecreationプラットフォームのE棟	exceptur
mission_location_stanton_697	REC-F	exceptur
mission_location_stanton_698	Prospect Point内、RecreationプラットフォームのF棟	exceptur
mission_location_stanton_699	REC-G	exceptur
mission_location_stanton_700	Prospect Point内、RecreationプラットフォームのG棟	exceptur
mission_location_stanton_701	REC-H	exceptur
mission_location_stanton_702	Prospect Point内、RecreationプラットフォームのH棟	exceptur
mission_location_stanton_703	REC-I	exceptur
mission_location_stanton_704	Prospect Point内、RecreationプラットフォームのI棟	exceptur
mission_location_stanton_705	ADMN-A	exceptur
mission_location_stanton_706	Prospect Point内、AdminプラットフォームのA棟	exceptur
mission_location_stanton_707	ADMN-B	exceptur
mission_location_stanton_708	Prospect Point内、AdminプラットフォームのB棟	exceptur
mission_location_stanton_709	ADMN-C	exceptur
mission_location_stanton_710	Prospect Point内、AdminプラットフォームのC棟	exceptur
mission_location_stanton_711	ADMN-D	exceptur
mission_location_stanton_712	Prospect Point内、AdminプラットフォームのD棟	exceptur
mission_location_stanton_713	ADMN-B	exceptur
mission_location_stanton_714	Empyrean Park内、AdminプラットフォームのB棟	exceptur
mission_location_stanton_715	ADMN-C	exceptur
mission_location_stanton_716	Empyrean Park内、AdminプラットフォームのC棟	exceptur
mission_location_stanton_717	ADMN-D	exceptur
mission_location_stanton_718	Empyrean Park内、AdminプラットフォームのD棟	exceptur
mission_location_stanton_719	RSRT-A	exceptur
mission_location_stanton_720	Empyrean Park内、ResortプラットフォームのA棟	exceptur
mission_location_stanton_721	RSRT-B	exceptur
mission_location_stanton_722	Empyrean Park内、ResortプラットフォームのB棟	exceptur
mission_location_stanton_723	RSRT-C	exceptur
mission_location_stanton_724	Empyrean Park内、ResortプラットフォームのC棟	exceptur
mission_location_stanton_725	RSRT-D	exceptur
mission_location_stanton_726	Empyrean Park内、ResortプラットフォームのD棟	exceptur
vehicle_DescDRAK_Cutter_Scout	メーカードレーク・インタープラネタリー\nフォーカス偵察\n\nドレイクは、カッターの荒削りでコンパクトなフレームを必要最低限にまで縮小し、すでに印象的だった船を理想的な偵察船へと変身させた。改良されたレーダーとスキャン機能、さらにパワーと冷却機能を備えたカッター・スカウトは、群れの先頭を飛ぶ準備ができている。	
vehicle_NameDRAK_Cutter_Cutter_Scout	Drake Cutter Scout	exceptur
vehicle_Namecrus_spirit	Crusader A1 Spirit	exceptur